urn:cts:mid:catullus.1:1	Cui dono lepidum novum libellum
urn:cts:mid:catullus.1:2	arida modo pumice expolitum?
urn:cts:mid:catullus.1:3	Corneli, tibi: namque tu solebas
urn:cts:mid:catullus.1:4	meas esse aliquid putare nugas.
urn:cts:mid:catullus.1:5	Iam tum, cum ausus es unus Italorum
urn:cts:mid:catullus.1:6	omne aevum tribus explicare cartis . . .
urn:cts:mid:catullus.1:7	Doctis, Iuppiter, et laboriosis!
urn:cts:mid:catullus.1:8	Quare habe tibi quidquid hoc libelli—
urn:cts:mid:catullus.1:9	qualecumque, quod, o patrona virgo,
urn:cts:mid:catullus.1:10	plus uno maneat perenne saeclo!
urn:cts:mid:catullus.10:1	Varus me meus ad suos amores
urn:cts:mid:catullus.10:2	visum duxerat e foro otiosum,
urn:cts:mid:catullus.10:3	scortillum, ut mihi tum repente visum est,
urn:cts:mid:catullus.10:4	non sane illepidum neque invenustum,
urn:cts:mid:catullus.10:5	huc ut venimus, incidere nobis
urn:cts:mid:catullus.10:6	sermones varii, in quibus, quid esset
urn:cts:mid:catullus.10:7	iam Bithynia, quo modo se haberet,
urn:cts:mid:catullus.10:8	et quonam mihi profuisset aere.
urn:cts:mid:catullus.10:9	respondi id quod erat, nihil neque ipsis
urn:cts:mid:catullus.10:10	nec praetoribus esse nec cohorti,
urn:cts:mid:catullus.10:11	cur quisquam caput unctius referret,
urn:cts:mid:catullus.10:12	praesertim quibus esset irrumator
urn:cts:mid:catullus.10:13	praetor, nec faceret pili cohortem.
urn:cts:mid:catullus.10:14	'at certe tamen,' inquiunt 'quod illic
urn:cts:mid:catullus.10:15	natum dicitur esse, comparasti
urn:cts:mid:catullus.10:16	ad lecticam homines.' ego, ut puellae
urn:cts:mid:catullus.10:17	unum me facerem beatiorem,
urn:cts:mid:catullus.10:18	'non' inquam 'mihi tam fuit maligne
urn:cts:mid:catullus.10:19	ut, provincia quod mala incidisset,
urn:cts:mid:catullus.10:20	non possem octo homines parare rectos.'
urn:cts:mid:catullus.10:21	at mi nullus erat nec hic neque illic
urn:cts:mid:catullus.10:22	fractum qui veteris pedem grabati
urn:cts:mid:catullus.10:23	in collo sibi collocare posset.
urn:cts:mid:catullus.10:24	hic illa, ut decuit cinaediorem,
urn:cts:mid:catullus.10:25	'quaeso' inquit 'mihi, mi Catulle, paulum
urn:cts:mid:catullus.10:26	istos commoda: nam volo ad Serapim
urn:cts:mid:catullus.10:27	deferri.' 'mane' inquii puellae,
urn:cts:mid:catullus.10:28	'istud quod modo dixeram me habere,
urn:cts:mid:catullus.10:29	fugit me ratio: meus sodalis—
urn:cts:mid:catullus.10:30	Cinna est Gaius—is sibi paravit.
urn:cts:mid:catullus.10:31	verum, utrum illius an mei, quid ad me?
urn:cts:mid:catullus.10:32	utor tam bene quam mihi pararim.
urn:cts:mid:catullus.10:33	sed tu insulsa male et molesta vivis,
urn:cts:mid:catullus.10:34	per quam non licet esse neglegentem.'
urn:cts:mid:catullus.100:1	Caelius Aufillenum et Qvintius Aufillenam
urn:cts:mid:catullus.100:2	flos Veronensum depereunt iuvenum,
urn:cts:mid:catullus.100:3	hic fratrem, ille sororem. hoc est, quod dicitur, illud
urn:cts:mid:catullus.100:4	fraternum vere dulce sodalicium.
urn:cts:mid:catullus.100:5	cui faveam potius? Caeli, tibi: nam tua nobis
urn:cts:mid:catullus.100:6	perspecta ex igni est unica amicitia,
urn:cts:mid:catullus.100:7	cum vesana meas torreret flamma medullas.
urn:cts:mid:catullus.100:8	sis felix, Caeli, sis in amore potens.
urn:cts:mid:catullus.101:1	Multas per gentes et multa per aequora vectus
urn:cts:mid:catullus.101:2	advenio has miseras, frater, ad inferias,
urn:cts:mid:catullus.101:3	ut te postremo donarem munere mortis
urn:cts:mid:catullus.101:4	et mutam nequiquam alloquerer cinerem.
urn:cts:mid:catullus.101:5	quandoquidem fortuna mihi tete abstulit ipsum.
urn:cts:mid:catullus.101:6	heu miser indigne frater adempte mihi,
urn:cts:mid:catullus.101:7	nunc tamen interea haec, prisco quae more parentum
urn:cts:mid:catullus.101:8	tradita sunt tristi munere ad inferias,
urn:cts:mid:catullus.101:9	accipe fraterno multum manantia fletu,
urn:cts:mid:catullus.101:10	atque in perpetuum, frater, ave atque vale.
urn:cts:mid:catullus.102:1	Si quicquam tacito commissum est fido ab amico,
urn:cts:mid:catullus.102:2	cuius sit penitus nota fides animi,
urn:cts:mid:catullus.102:3	meque esse invenies illorum iure sacratum,
urn:cts:mid:catullus.102:4	Corneli, et factum me esse puta Arpocratem.
urn:cts:mid:catullus.103:1	Aut sodes mihi redde decem sestertia, Silo,
urn:cts:mid:catullus.103:2	deinde esto quamvis saevus et indomitus:
urn:cts:mid:catullus.103:3	aut, si te nummi delectant, desine quaeso
urn:cts:mid:catullus.103:4	leno esse atque idem saevus et indomitus.
urn:cts:mid:catullus.104:1	Credis me potuisse meae maledicere vitae,
urn:cts:mid:catullus.104:2	ambobus mihi quae carior est oculis?
urn:cts:mid:catullus.104:3	non potui, nec, si possem, tam perdite amarem:
urn:cts:mid:catullus.104:4	sed tu cum Tappone omnia monstra facis.
urn:cts:mid:catullus.105:1	Mentula conatur Pipleium scandere montem:
urn:cts:mid:catullus.105:2	Musae furcillis praecipitem eiciunt.
urn:cts:mid:catullus.106:1	Cum puero bello praeconem qui videt esse,
urn:cts:mid:catullus.106:2	quid credat, nisi se vendere discupere?
urn:cts:mid:catullus.107:1	Si quicquam cupido optantique optigit umquam
urn:cts:mid:catullus.107:2	insperanti, hoc est gratum animo proprie.
urn:cts:mid:catullus.107:3	quare hoc est gratum nobis quoque carius auro
urn:cts:mid:catullus.107:4	quod te restituis, Lesbia, mi cupido.
urn:cts:mid:catullus.107:5	restituis cupido atque insperanti, ipsa refers te
urn:cts:mid:catullus.107:6	nobis. o lucem candidiore nota!
urn:cts:mid:catullus.107:7	quis me uno vivit felicior aut magis hac est
urn:cts:mid:catullus.107:8	optandus vita dicere quis poterit?
urn:cts:mid:catullus.108:1	Si, Comini, populi arbitrio tua cana senectus
urn:cts:mid:catullus.108:2	spurcata impuris moribus intereat,
urn:cts:mid:catullus.108:3	non equidem dubito quin primum inimica bonorum
urn:cts:mid:catullus.108:4	lingua exsecta avido sit data vulturio,
urn:cts:mid:catullus.108:5	effossos oculos voret atro gutture coruus,
urn:cts:mid:catullus.108:6	intestina canes, cetera membra lupi.
urn:cts:mid:catullus.109:1	Iucundum, mea vita, mihi proponis amorem
urn:cts:mid:catullus.109:2	hunc nostrum inter nos perpetuumque fore.
urn:cts:mid:catullus.109:3	di magni, facite ut vere promittere possit,
urn:cts:mid:catullus.109:4	atque id sincere dicat et ex animo,
urn:cts:mid:catullus.109:5	ut liceat nobis tota perducere vita
urn:cts:mid:catullus.109:6	aeternum hoc sanctae foedus amicitiae.
urn:cts:mid:catullus.11:1	Furi et Aureli comites Catulli,
urn:cts:mid:catullus.11:2	sive in extremos penetrabit Indos,
urn:cts:mid:catullus.11:3	litus ut longe resonante Eoa
urn:cts:mid:catullus.11:4	tunditur unda,
urn:cts:mid:catullus.11:5	sive in Hyrcanos Arabesve molles,
urn:cts:mid:catullus.11:6	seu Sagas sagittiferosve Parthos,
urn:cts:mid:catullus.11:7	sive quae septemgeminus colorat
urn:cts:mid:catullus.11:8	aequora Nilus,
urn:cts:mid:catullus.11:9	sive trans altas gradietur Alpes,
urn:cts:mid:catullus.11:10	Caesaris visens monimenta magni,
urn:cts:mid:catullus.11:11	Gallicum Rhenum horribile aequor ulti-
urn:cts:mid:catullus.11:12	mosque Britannos,
urn:cts:mid:catullus.11:13	omnia haec, quaecumque feret voluntas
urn:cts:mid:catullus.11:14	caelitum, temptare simul parati,
urn:cts:mid:catullus.11:15	pauca nuntiate meae puellae
urn:cts:mid:catullus.11:16	non bona dicta.
urn:cts:mid:catullus.11:17	cum suis vivat valeatque moechis,
urn:cts:mid:catullus.11:18	quos simul complexa tenet trecentos,
urn:cts:mid:catullus.11:19	nullum amans vere, sed identidem omnium
urn:cts:mid:catullus.11:20	ilia rumpens;
urn:cts:mid:catullus.11:21	nec meum respectet, ut ante, amorem,
urn:cts:mid:catullus.11:22	qui illius culpa cecidit velut prati
urn:cts:mid:catullus.11:23	ultimi flos, praetereunte postquam
urn:cts:mid:catullus.11:24	tactus aratro est.
urn:cts:mid:catullus.110:1	Aufilena, bonae semper laudantur amicae:
urn:cts:mid:catullus.110:2	accipiunt pretium, quae facere instituunt.
urn:cts:mid:catullus.110:3	tu, quod promisti, mihi quod mentita inimica es,
urn:cts:mid:catullus.110:4	quod nec das et fers saepe, facis facinus.
urn:cts:mid:catullus.110:5	aut facere ingenuae est, aut non promisse pudicae,
urn:cts:mid:catullus.110:6	Aufillena, fuit: sed data corripere
urn:cts:mid:catullus.110:7	fraudando officiis, plus quam meretricis avarae
urn:cts:mid:catullus.110:8	quae sese toto corpore prostituit.
urn:cts:mid:catullus.111:1	Aufilena, viro contentam vivere solo,
urn:cts:mid:catullus.111:2	nuptarum laus ex laudibus eximiis:
urn:cts:mid:catullus.111:3	sed cuivis quamvis potius succumbere par est,
urn:cts:mid:catullus.111:4	quam matrem fratres efficere ex patruo…
urn:cts:mid:catullus.112:1	Multus homo es, Naso, neque tecum multus homo
urn:cts:mid:catullus.112:2	te scindat: Naso, multus es et pathicus.
urn:cts:mid:catullus.113:1	Consule Pompeio primum duo, Cinna, solebant
urn:cts:mid:catullus.113:2	Maeciliam: facto consule nunc iterum
urn:cts:mid:catullus.113:3	manserunt duo, sed creverunt milia in unum
urn:cts:mid:catullus.113:4	singula. fecundum semen adulterio.
urn:cts:mid:catullus.114:1	Firmanus saltu non falso Mentula diues
urn:cts:mid:catullus.114:2	fertur, qui tot res in se habet egregias,
urn:cts:mid:catullus.114:3	aucupium omne genus, piscis, prata, arva ferasque.
urn:cts:mid:catullus.114:4	nequiquam: fructus sumptibus exsuperat.
urn:cts:mid:catullus.114:5	quare concedo sit diues, dum omnia desint.
urn:cts:mid:catullus.114:6	saltum laudemus, dum modo ipse egeat.
urn:cts:mid:catullus.115:1	Mentula habet instar triginta iugera prati,
urn:cts:mid:catullus.115:2	quadraginta arui: cetera sunt maria.
urn:cts:mid:catullus.115:3	cur non divitiis Croesum superare potis sit,
urn:cts:mid:catullus.115:4	uno qui in saltu tot bona possideat,
urn:cts:mid:catullus.115:5	prata arva ingentes silvas saltusque paludesque
urn:cts:mid:catullus.115:6	usque ad Hyperboreos et mare ad Oceanum?
urn:cts:mid:catullus.115:7	omnia magna haec sunt, tamen ipsest maximus ultro,
urn:cts:mid:catullus.115:8	non homo, sed vero mentula magna minax.
urn:cts:mid:catullus.116:1	Saepe tibi studioso animo venante requirens
urn:cts:mid:catullus.116:2	carmina uti possem mittere Battiadae,
urn:cts:mid:catullus.116:3	qui te lenirem nobis, neu conarere
urn:cts:mid:catullus.116:4	tela infesta mittere in usque caput,
urn:cts:mid:catullus.116:5	hunc video mihi nunc frustra sumptum esse laborem,
urn:cts:mid:catullus.116:6	Gelli, nec nostras hic valuisse preces.
urn:cts:mid:catullus.116:7	contra nos tela ista tua evitabimus amitha
urn:cts:mid:catullus.116:8	at fixus nostris tu dabis supplicium.
urn:cts:mid:catullus.12:1	Marrucine Asini, manu sinistra
urn:cts:mid:catullus.12:2	non belle uteris: in ioco atque vino
urn:cts:mid:catullus.12:3	tollis lintea neglegentiorum.
urn:cts:mid:catullus.12:4	hoc salsum esse putas? fugit te, inepte:
urn:cts:mid:catullus.12:5	quamvis sordida res et invenusta est.
urn:cts:mid:catullus.12:6	non credis mihi? crede Pollioni
urn:cts:mid:catullus.12:7	fratri, qui tua furta vel talento
urn:cts:mid:catullus.12:8	mutari velit: est enim leporum
urn:cts:mid:catullus.12:9	differtus puer ac facetiarum.
urn:cts:mid:catullus.12:10	quare aut hendecasyllabos trecentos
urn:cts:mid:catullus.12:11	exspecta, aut mihi linteum remitte,
urn:cts:mid:catullus.12:12	quod me non movet aestimatione,
urn:cts:mid:catullus.12:13	verum est mnemosynum mei sodalis.
urn:cts:mid:catullus.12:14	nam sudaria Saetaba ex Hiberis
urn:cts:mid:catullus.12:15	miserunt mihi muneri Fabullus
urn:cts:mid:catullus.12:16	et Veranius: haec amem necesse est
urn:cts:mid:catullus.12:17	ut Veraniolum meum et Fabullum.
urn:cts:mid:catullus.13:1	Cenabis bene, mi Fabulle, apud me
urn:cts:mid:catullus.13:2	paucis, si tibi di favent, diebus,
urn:cts:mid:catullus.13:3	si tecum attuleris bonam atque magnam
urn:cts:mid:catullus.13:4	cenam, non sine candida puella
urn:cts:mid:catullus.13:5	et vino et sale et omnibus cachinnis.
urn:cts:mid:catullus.13:6	haec si, inquam, attuleris, venuste noster,
urn:cts:mid:catullus.13:7	cenabis bene; nam tui Catulli
urn:cts:mid:catullus.13:8	plenus sacculus est aranearum.
urn:cts:mid:catullus.13:9	sed contra accipies meros amores
urn:cts:mid:catullus.13:10	seu quid suavius elegantiusve est:
urn:cts:mid:catullus.13:11	nam unguentum dabo, quod meae puellae
urn:cts:mid:catullus.13:12	donarunt Veneres Cupidinesque,
urn:cts:mid:catullus.13:13	quod tu cum olfacies, deos rogabis,
urn:cts:mid:catullus.13:14	totum ut te faciant, Fabulle, nasum.
urn:cts:mid:catullus.14:1	Ni te plus oculis meis amarem,
urn:cts:mid:catullus.14:2	iucundissime Calve, munere isto
urn:cts:mid:catullus.14:3	odissem te odio Vatiniano:
urn:cts:mid:catullus.14:4	nam quid feci ego quidve sum locutus,
urn:cts:mid:catullus.14:5	cur me tot male perderes poetis?
urn:cts:mid:catullus.14:6	isti di mala multa dent clienti,
urn:cts:mid:catullus.14:7	qui tantum tibi misit impiorum.
urn:cts:mid:catullus.14:8	quod si, ut suspicor, hoc novum ac repertum
urn:cts:mid:catullus.14:9	munus dat tibi Sulla litterator,
urn:cts:mid:catullus.14:10	non est mi male, sed bene ac beate,
urn:cts:mid:catullus.14:11	quod non dispereunt tui labores.
urn:cts:mid:catullus.14:12	di magni, horribilem et sacrum libellum!
urn:cts:mid:catullus.14:13	quem tu scilicet ad tuum Catullum
urn:cts:mid:catullus.14:14	misti, continuo ut die periret,
urn:cts:mid:catullus.14:15	Saturnalibus, optimo dierum!
urn:cts:mid:catullus.14:16	non non hoc tibi, false, sic abibit.
urn:cts:mid:catullus.14:17	nam si luxerit ad librariorum
urn:cts:mid:catullus.14:18	curram scrinia, Caesios, Aquinos,
urn:cts:mid:catullus.14:19	Suffenum, omnia colligam venena.
urn:cts:mid:catullus.14:20	ac te his suppliciis remunerabor.
urn:cts:mid:catullus.14:21	vos hinc interea valete abite
urn:cts:mid:catullus.14:22	illuc, unde malum pedem attulistis,
urn:cts:mid:catullus.14:23	saecli incommoda, pessimi poetae.
urn:cts:mid:catullus.14b:1	Si qui forte mearum ineptiarum
urn:cts:mid:catullus.14b:2	lectores eritis manusque vestras
urn:cts:mid:catullus.14b:3	non horrebitis admovere nobis,
urn:cts:mid:catullus.15:1	Commendo tibi me ac meos amores,
urn:cts:mid:catullus.15:2	Aureli. veniam peto pudentem,
urn:cts:mid:catullus.15:3	ut, si quicquam animo tuo cupisti,
urn:cts:mid:catullus.15:4	quod castum expeteres et integellum,
urn:cts:mid:catullus.15:5	conserves puerum mihi pudice,
urn:cts:mid:catullus.15:6	non dico a populo—nihil veremur
urn:cts:mid:catullus.15:7	istos, qui in platea modo huc modo illuc
urn:cts:mid:catullus.15:8	in re praetereunt sua occupati—
urn:cts:mid:catullus.15:9	verum a te metuo tuoque pene
urn:cts:mid:catullus.15:10	infesto pueris bonis malisque.
urn:cts:mid:catullus.15:11	quem tu qua lubet, ut lubet moveto
urn:cts:mid:catullus.15:12	quantum vis, ubi erit foris paratum:
urn:cts:mid:catullus.15:13	hunc unum excipio, ut puto, pudenter.
urn:cts:mid:catullus.15:14	quod si te mala mens furorque vecors
urn:cts:mid:catullus.15:15	in tantam impulerit, sceleste, culpam,
urn:cts:mid:catullus.15:16	ut nostrum insidiis caput lacessas.
urn:cts:mid:catullus.15:17	a tum te miserum malique fati!
urn:cts:mid:catullus.15:18	quem attractis pedibus patente porta
urn:cts:mid:catullus.15:19	percurrent raphanique mugilesque.
urn:cts:mid:catullus.16:1	Pedicabo ego vos et irrumabo,
urn:cts:mid:catullus.16:2	Aureli pathice et cinaede Furi,
urn:cts:mid:catullus.16:3	qui me ex versiculis meis putastis,
urn:cts:mid:catullus.16:4	quod sunt molliculi, parum pudicum.
urn:cts:mid:catullus.16:5	nam castum esse decet pium poetam
urn:cts:mid:catullus.16:6	ipsum, versiculos nihil necesse est;
urn:cts:mid:catullus.16:7	qui tum denique habent salem ac leporem,
urn:cts:mid:catullus.16:8	si sunt molliculi ac parum pudici,
urn:cts:mid:catullus.16:9	et quod pruriat incitare possunt,
urn:cts:mid:catullus.16:10	non dico pueris, sed his pilosis
urn:cts:mid:catullus.16:11	qui duros nequeunt movere lumbos.
urn:cts:mid:catullus.16:12	vos, quod milia multa basiorum
urn:cts:mid:catullus.16:13	legistis, male me marem putatis?
urn:cts:mid:catullus.16:14	pedicabo ego vos et irrumabo.
urn:cts:mid:catullus.17:1	O Colonia, quae cupis ponte ludere longo,
urn:cts:mid:catullus.17:2	et salire paratum habes, sed vereris inepta
urn:cts:mid:catullus.17:3	crura ponticuli axulis stantis in redivivis,
urn:cts:mid:catullus.17:4	ne supinus eat cavaque in palude recumbat:
urn:cts:mid:catullus.17:5	sic tibi bonus ex tua pons libidine fiat,
urn:cts:mid:catullus.17:6	in quo vel Salisubsali sacra suscipiantur,
urn:cts:mid:catullus.17:7	munus hoc mihi maximi da, Colonia, risus.
urn:cts:mid:catullus.17:8	quendam municipem meum de tuo volo ponte
urn:cts:mid:catullus.17:9	ire praecipitem in lutum per caputque pedesque,
urn:cts:mid:catullus.17:10	verum totius ut lacus putidaeque paludis
urn:cts:mid:catullus.17:11	lividissima maximeque est profunda vorago.
urn:cts:mid:catullus.17:12	insulsissimus est homo, nec sapit pueri instar
urn:cts:mid:catullus.17:13	bimuli tremula patris dormientis in ulna.
urn:cts:mid:catullus.17:14	cui cum sit viridissimo nupta flore puella
urn:cts:mid:catullus.17:15	et puella tenellulo delicatior haedo,
urn:cts:mid:catullus.17:16	adservanda nigerrimis diligentius uuis,
urn:cts:mid:catullus.17:17	ludere hanc sinit ut lubet, nec pili facit uni,
urn:cts:mid:catullus.17:18	nec se subleuat ex sua parte, sed velut alnus
urn:cts:mid:catullus.17:19	in fossa Liguri iacet suppernata securi,
urn:cts:mid:catullus.17:20	tantundem omnia sentiens quam si nulla sit usquam;
urn:cts:mid:catullus.17:21	talis iste meus stupor nil videt, nihil audit,
urn:cts:mid:catullus.17:22	ipse qui sit, utrum sit an non sit, id quoque nescit.
urn:cts:mid:catullus.17:23	nunc eum volo de tuo ponte mittere pronum,
urn:cts:mid:catullus.17:24	si pote stolidum repente excitare veternum,
urn:cts:mid:catullus.17:25	et supinum animum in gravi derelinquere caeno,
urn:cts:mid:catullus.17:26	ferream ut soleam tenaci in voragine mula.
urn:cts:mid:catullus.2:1	Passer, deliciae meae puellae,
urn:cts:mid:catullus.2:2	quicum ludere, quem in sinu tenere,
urn:cts:mid:catullus.2:3	cui primum digitum dare appetenti
urn:cts:mid:catullus.2:4	et acris solet incitare morsus,
urn:cts:mid:catullus.2:5	cum desiderio meo nitenti
urn:cts:mid:catullus.2:6	carum nescio quid lubet iocari
urn:cts:mid:catullus.2:7	et solaciolum sui doloris,
urn:cts:mid:catullus.2:8	credo ut tum gravis acquiescat ardor:
urn:cts:mid:catullus.2:9	tecum ludere sicut ipsa possem
urn:cts:mid:catullus.2:10	et tristis animi levare curas!
urn:cts:mid:catullus.21:1	Aureli, pater esuritionum,
urn:cts:mid:catullus.21:2	non harum modo, sed quot aut fuerunt
urn:cts:mid:catullus.21:3	aut sunt aut aliis erunt in annis,
urn:cts:mid:catullus.21:4	pedicare cupis meos amores.
urn:cts:mid:catullus.21:5	nec clam: nam simul es, iocaris una,
urn:cts:mid:catullus.21:6	haerens ad latus omnia experiris.
urn:cts:mid:catullus.21:7	frustra: nam insidias mihi instruentem
urn:cts:mid:catullus.21:8	tangam te prior irrumatione.
urn:cts:mid:catullus.21:9	atque id si faceres satur, tacerem:
urn:cts:mid:catullus.21:10	nunc ipsum id doleo, quod esurire
urn:cts:mid:catullus.21:11	me me puer et sitire discet.
urn:cts:mid:catullus.21:12	quare desine, dum licet pudico,
urn:cts:mid:catullus.21:13	ne finem facias, sed irrumatus.
urn:cts:mid:catullus.22:1	Suffenus iste, Vare, quem probe nosti,
urn:cts:mid:catullus.22:2	homo est venustus et dicax et urbanus,
urn:cts:mid:catullus.22:3	idemque longe plurimos facit versus.
urn:cts:mid:catullus.22:4	puto esse ego illi milia aut decem aut plura
urn:cts:mid:catullus.22:5	perscripta, nec sic ut fit in palimpsesto
urn:cts:mid:catullus.22:6	relata: cartae regiae, novi libri,
urn:cts:mid:catullus.22:7	novi umbilici, lora rubra membranae,
urn:cts:mid:catullus.22:8	derecta plumbo et pumice omnia aequata.
urn:cts:mid:catullus.22:9	haec cum legas tu, bellus ille et urbanus
urn:cts:mid:catullus.22:10	Suffenus unus caprimulgus aut fossor
urn:cts:mid:catullus.22:11	rursus videtur: tantum abhorret ac mutat.
urn:cts:mid:catullus.22:12	hoc quid putemus esse? qui modo scurra
urn:cts:mid:catullus.22:13	aut si quid hac re scitius videbatur,
urn:cts:mid:catullus.22:14	idem infaceto est infacetior rure,
urn:cts:mid:catullus.22:15	simul poemata attigit, neque idem umquam
urn:cts:mid:catullus.22:16	aeque est beatus ac poema cum scribit:
urn:cts:mid:catullus.22:17	tam gaudet in se tamque se ipse miratur.
urn:cts:mid:catullus.22:18	nimirum idem omnes fallimur, neque est quisquam
urn:cts:mid:catullus.22:19	quem non in aliqua re videre Suffenum
urn:cts:mid:catullus.22:20	possis. suus cuique attributus est error;
urn:cts:mid:catullus.22:21	sed non videmus manticae quod in tergo est.
urn:cts:mid:catullus.23:1	Furi cui neque servus est neque arca
urn:cts:mid:catullus.23:2	nec cimex neque araneus neque ignis,
urn:cts:mid:catullus.23:3	verum est et pater et noverca, quorum
urn:cts:mid:catullus.23:4	dentes vel silicem comesse possunt,
urn:cts:mid:catullus.23:5	est pulcre tibi cum tuo parente
urn:cts:mid:catullus.23:6	et cum coniuge lignea parentis.
urn:cts:mid:catullus.23:7	nec mirum: bene nam valetis omnes,
urn:cts:mid:catullus.23:8	pulcre concoquitis, nihil timetis,
urn:cts:mid:catullus.23:9	non incendia, non graves rvinas,
urn:cts:mid:catullus.23:10	non facta impia, non dolos veneni,
urn:cts:mid:catullus.23:11	non casus alios periculorum.
urn:cts:mid:catullus.23:12	atque corpora sicciora cornu
urn:cts:mid:catullus.23:13	aut siquid magis aridum est habetis
urn:cts:mid:catullus.23:14	sole et frigore et esuritione.
urn:cts:mid:catullus.23:15	quare non tibi sit bene ac beate?
urn:cts:mid:catullus.23:16	a te sudor abest, abest saliva,
urn:cts:mid:catullus.23:17	mucusque et mala pituita nasi.
urn:cts:mid:catullus.23:18	hanc ad munditiem adde mundiorem,
urn:cts:mid:catullus.23:19	quod culus tibi purior salillo est,
urn:cts:mid:catullus.23:20	nec toto decies cacas in anno;
urn:cts:mid:catullus.23:21	atque id durius est faba et lapillis.
urn:cts:mid:catullus.23:22	quod tu si manibus teras fricesque,
urn:cts:mid:catullus.23:23	non umquam digitum inquinare posses
urn:cts:mid:catullus.23:24	haec tu commoda tam beata, Furi,
urn:cts:mid:catullus.23:25	noli spernere nec putare parvi,
urn:cts:mid:catullus.23:26	et sestertia quae soles precari
urn:cts:mid:catullus.23:27	centum desine: nam sat es beatus.
urn:cts:mid:catullus.24:1	O qui flosculus es Iuventiorum,
urn:cts:mid:catullus.24:2	non horum modo, sed quot aut fuerunt
urn:cts:mid:catullus.24:3	aut posthac aliis erunt in annis,
urn:cts:mid:catullus.24:4	mallem divitias Midae dedisses
urn:cts:mid:catullus.24:5	isti, cui neque servus est neque arca,
urn:cts:mid:catullus.24:6	quam sic te sineres ab illo amari.
urn:cts:mid:catullus.24:7	'qui? non est homo bellus?' inquies. est:
urn:cts:mid:catullus.24:8	sed bello huic neque servus est neque arca.
urn:cts:mid:catullus.24:9	hoc tu quam lubet abice elevaque:
urn:cts:mid:catullus.24:10	nec servum tamen ille habet neque arcam.
urn:cts:mid:catullus.25:1	Cinaede Thalle, mollior cuniculi capillo
urn:cts:mid:catullus.25:2	vel anseris medullula vel imula oricilla
urn:cts:mid:catullus.25:3	vel pene languido senis situque araneoso,
urn:cts:mid:catullus.25:4	idemque, Thalle, turbida rapacior procella,
urn:cts:mid:catullus.25:5	cum diva mulier aries ostendit oscitantes,
urn:cts:mid:catullus.25:6	remitte pallium mihi meum, quod involasti,
urn:cts:mid:catullus.25:7	sudariumque Saetabum catagraphosque Thynos,
urn:cts:mid:catullus.25:8	inepte, quae palam soles habere tamquam avita.
urn:cts:mid:catullus.25:9	quae nunc tuis ab unguibus reglutina et remitte,
urn:cts:mid:catullus.25:10	ne laneum latusculum manusque mollicellas
urn:cts:mid:catullus.25:11	inusta turpiter tibi flagella conscribillent,
urn:cts:mid:catullus.25:12	et insolenter aestues, velut minuta magno
urn:cts:mid:catullus.25:13	deprensa navis in mari, vesaniente vento.
urn:cts:mid:catullus.26:1	Furi villula vestra non ad Austri
urn:cts:mid:catullus.26:2	flatus opposita est neque ad Favoni
urn:cts:mid:catullus.26:3	nec saevi Boreae aut Apheliotae,
urn:cts:mid:catullus.26:4	verum ad milia quindecim et ducentos.
urn:cts:mid:catullus.26:5	o ventum horribilem atque pestilentem!
urn:cts:mid:catullus.27:1	Minister vetuli puer Falerni
urn:cts:mid:catullus.27:2	inger mi calices amariores,
urn:cts:mid:catullus.27:3	ut lex Postumiae iubet magistrae
urn:cts:mid:catullus.27:4	ebrioso acino ebriosioris.
urn:cts:mid:catullus.27:5	at vos quo lubet hinc abite, lymphae
urn:cts:mid:catullus.27:6	vini pernicies, et ad severos
urn:cts:mid:catullus.27:7	migrate. hic merus est Thyonianus.
urn:cts:mid:catullus.28:1	Pisonis comites, cohors inanis,
urn:cts:mid:catullus.28:2	aptis sarcinulis et expeditis,
urn:cts:mid:catullus.28:3	Verani optime tuque mi Fabulle,
urn:cts:mid:catullus.28:4	quid rerum geritis? satisne cum isto
urn:cts:mid:catullus.28:5	vappa frigoraque et famem tulistis?
urn:cts:mid:catullus.28:6	ecquidnam in tabulis patet lucelli
urn:cts:mid:catullus.28:7	expensum, ut mihi, qui meum secutus
urn:cts:mid:catullus.28:8	praetorem refero datum lucello?
urn:cts:mid:catullus.28:9	o Memmi, bene me ac diu supinum
urn:cts:mid:catullus.28:10	tota ista trabe lentus irrumasti.
urn:cts:mid:catullus.28:11	sed, quantum video, pari fuistis
urn:cts:mid:catullus.28:12	casu: nam nihilo minore verpa
urn:cts:mid:catullus.28:13	farti estis. pete nobiles amicos!
urn:cts:mid:catullus.28:14	at vobis mala multa di deaeque
urn:cts:mid:catullus.28:15	dent, opprobria Romuli Remique.
urn:cts:mid:catullus.29:1	Quis hoc potest videre, quis potest pati,
urn:cts:mid:catullus.29:2	nisi impudicus et vorax et aleo,
urn:cts:mid:catullus.29:3	Mamurram habere quod Comata Gallia
urn:cts:mid:catullus.29:4	habebat uncti et ultima Britannia?
urn:cts:mid:catullus.29:5	cinaede Romule haec videbis et feres?
urn:cts:mid:catullus.29:6	et ille nunc superbus et superfluens
urn:cts:mid:catullus.29:7	perambulabit omnium cubilia,
urn:cts:mid:catullus.29:8	ut albulus columbus aut Adoneus?
urn:cts:mid:catullus.29:9	cinaede Romule, haec videbis et feres?
urn:cts:mid:catullus.29:10	es impudicus et vorax et aleo.
urn:cts:mid:catullus.29:11	eone nomine, imperator unice,
urn:cts:mid:catullus.29:12	fuisti in ultima occidentis insula,
urn:cts:mid:catullus.29:13	ut ista vestra diffututa mentula
urn:cts:mid:catullus.29:14	ducenties comesset aut trecenties?
urn:cts:mid:catullus.29:15	quid est alid sinistra liberalitas?
urn:cts:mid:catullus.29:16	parum expatravit an parum elluatus est?
urn:cts:mid:catullus.29:17	paterna prima lancinata sunt bona,
urn:cts:mid:catullus.29:18	secunda praeda Pontica, inde tertia
urn:cts:mid:catullus.29:19	Hibera, quam scit amnis aurifer Tagus:
urn:cts:mid:catullus.29:20	nunc Galliae timetur et Britanniae.
urn:cts:mid:catullus.29:21	quid hunc malum fovetis? aut quid hic potest
urn:cts:mid:catullus.29:22	nisi uncta devorare patrimonia?
urn:cts:mid:catullus.29:23	eone nomine urbis opulentissime
urn:cts:mid:catullus.29:24	socer generque, perdidistis omnia?
urn:cts:mid:catullus.2b:1	Tam gratum est mihi quam ferunt puellae
urn:cts:mid:catullus.2b:2	pernici aureolum fuisse malum,
urn:cts:mid:catullus.2b:3	quod zonam soluit diu ligatam.
urn:cts:mid:catullus.3:1	Lugete, o Veneres Cupidinesque,
urn:cts:mid:catullus.3:2	et quantum est hominum venustiorum:
urn:cts:mid:catullus.3:3	passer mortuus est meae puellae,
urn:cts:mid:catullus.3:4	passer, deliciae meae puellae,
urn:cts:mid:catullus.3:5	quem plus illa oculis suis amabat.
urn:cts:mid:catullus.3:6	nam mellitus erat suamque norat
urn:cts:mid:catullus.3:7	ipsam tam bene quam puella matrem,
urn:cts:mid:catullus.3:8	nec sese a gremio illius movebat,
urn:cts:mid:catullus.3:9	sed circumsiliens modo huc modo illuc
urn:cts:mid:catullus.3:10	ad solam dominam usque pipiabat.
urn:cts:mid:catullus.3:11	qui nunc it per iter tenebricosum
urn:cts:mid:catullus.3:12	illuc, unde negant redire quemquam.
urn:cts:mid:catullus.3:13	at vobis male sit, malae tenebrae
urn:cts:mid:catullus.3:14	Orci, quae omnia bella devoratis:
urn:cts:mid:catullus.3:15	tam bellum mihi passerem abstulistis
urn:cts:mid:catullus.3:16	o factum male! o miselle passer!
urn:cts:mid:catullus.3:17	tua nunc opera meae puellae
urn:cts:mid:catullus.3:18	flendo turgiduli rubent ocelli.
urn:cts:mid:catullus.30:1	Alfene immemor atque unanimis false sodalibus,
urn:cts:mid:catullus.30:2	iam te nil miseret, dure, tui dulcis amiculi?
urn:cts:mid:catullus.30:3	iam me prodere, iam non dubitas fallere, perfide?
urn:cts:mid:catullus.30:4	nec facta impia fallacum hominum caelicolis placent.
urn:cts:mid:catullus.30:5	quae tu neglegis ac me miserum deseris in malis.
urn:cts:mid:catullus.30:6	eheu quid faciant, dic, homines cuive habeant fidem?
urn:cts:mid:catullus.30:7	certe tute iubebas animam tradere, inique, me
urn:cts:mid:catullus.30:8	inducens in amorem, quasi tuta omnia mi forent.
urn:cts:mid:catullus.30:9	idem nunc retrahis te ac tua dicta omnia factaque
urn:cts:mid:catullus.30:10	ventos irrita ferre ac nebulas aereas sinis.
urn:cts:mid:catullus.30:11	si tu oblitus es, at di meminerunt, meminit Fides,
urn:cts:mid:catullus.30:12	quae te ut paeniteat postmodo facti faciet tui.
urn:cts:mid:catullus.31:1	Paene insularum, Sirmio, insularumque
urn:cts:mid:catullus.31:2	ocelle, quascumque in liquentibus stagnis
urn:cts:mid:catullus.31:3	marique vasto fert uterque Neptunus,
urn:cts:mid:catullus.31:4	quam te libenter quamque laetus inviso,
urn:cts:mid:catullus.31:5	vix mi ipse credens Thuniam atque Bithunos
urn:cts:mid:catullus.31:6	liquisse campos et videre te in tuto.
urn:cts:mid:catullus.31:7	o quid solutis est beatius curis,
urn:cts:mid:catullus.31:8	cum mens onus reponit, ac peregrino
urn:cts:mid:catullus.31:9	labore fessi venimus larem ad nostrum,
urn:cts:mid:catullus.31:10	desideratoque acquiescimus lecto?
urn:cts:mid:catullus.31:11	hoc est quod unum est pro laboribus tantis.
urn:cts:mid:catullus.31:12	salve, o venusta Sirmio, atque ero gaude
urn:cts:mid:catullus.31:13	gaudente, vosque, o Lydiae lacus undae,
urn:cts:mid:catullus.31:14	ridete quidquid est domi cachinnorum.
urn:cts:mid:catullus.32:1	Amabo, mea dulcis Ipsitilla,
urn:cts:mid:catullus.32:2	meae deliciae, mei lepores,
urn:cts:mid:catullus.32:3	iube ad te veniam meridiatum.
urn:cts:mid:catullus.32:4	et si iusseris, illud adiuvato,
urn:cts:mid:catullus.32:5	ne quis liminis obseret tabellam,
urn:cts:mid:catullus.32:6	neu tibi lubeat foras abire,
urn:cts:mid:catullus.32:7	sed domi maneas paresque nobis
urn:cts:mid:catullus.32:8	novem continuas fututiones.
urn:cts:mid:catullus.32:9	verum si quid ages, statim iubeto:
urn:cts:mid:catullus.32:10	nam pransus iaceo et satur supinus
urn:cts:mid:catullus.32:11	pertundo tunicamque palliumque.
urn:cts:mid:catullus.33:1	O Furum optime balneariorum
urn:cts:mid:catullus.33:2	Vibenni pater et cinaede fili
urn:cts:mid:catullus.33:3	(nam dextra pater inquinatiore,
urn:cts:mid:catullus.33:4	culo filius est voraciore),
urn:cts:mid:catullus.33:5	cur non exilium malasque in oras
urn:cts:mid:catullus.33:6	itis? quandoquidem patris rapinae
urn:cts:mid:catullus.33:7	notae sunt populo, et natis pilosas,
urn:cts:mid:catullus.33:8	fili, non potes asse venditare.
urn:cts:mid:catullus.34:1	Dianae sumus in fide
urn:cts:mid:catullus.34:2	puellae et pueri integri:
urn:cts:mid:catullus.34:3	Dianam pueri integri
urn:cts:mid:catullus.34:4	puellaeque canamus.
urn:cts:mid:catullus.34:5	
urn:cts:mid:catullus.34:6	o Latonia, maximi
urn:cts:mid:catullus.34:7	magna progenies Iovis,
urn:cts:mid:catullus.34:8	quam mater prope Deliam
urn:cts:mid:catullus.34:9	deposiuit olivam,
urn:cts:mid:catullus.34:10	
urn:cts:mid:catullus.34:11	montium domina ut fores
urn:cts:mid:catullus.34:12	silvarumque virentium
urn:cts:mid:catullus.34:13	saltuumque reconditorum
urn:cts:mid:catullus.34:14	amniumque sonantum:
urn:cts:mid:catullus.34:15	
urn:cts:mid:catullus.34:16	tu Lucina dolentibus
urn:cts:mid:catullus.34:17	Iuno dicta puerperis,
urn:cts:mid:catullus.34:18	tu potens Trivia et notho es
urn:cts:mid:catullus.34:19	dicta lumine Luna.
urn:cts:mid:catullus.34:20	
urn:cts:mid:catullus.34:21	tu cursu, dea, menstruo
urn:cts:mid:catullus.34:22	metiens iter annuum,
urn:cts:mid:catullus.34:23	rustica agricolae bonis
urn:cts:mid:catullus.34:24	tecta frugibus exples.
urn:cts:mid:catullus.34:25	
urn:cts:mid:catullus.34:26	sis quocumque tibi placet
urn:cts:mid:catullus.34:27	sancta nomine, Romulique,
urn:cts:mid:catullus.34:28	antique ut solita es, bona
urn:cts:mid:catullus.34:29	sospites ope gentem.
urn:cts:mid:catullus.35:1	Poetae tenero, meo sodali,
urn:cts:mid:catullus.35:2	velim Caecilio, papyre, dicas
urn:cts:mid:catullus.35:3	Veronam veniat, Noui relinquens
urn:cts:mid:catullus.35:4	Comi moenia Lariumque litus.
urn:cts:mid:catullus.35:5	nam quasdam volo cogitationes
urn:cts:mid:catullus.35:6	amici accipiat sui meique.
urn:cts:mid:catullus.35:7	quare, si sapiet, viam vorabit,
urn:cts:mid:catullus.35:8	quamvis candida milies puella
urn:cts:mid:catullus.35:9	euntem revocet, manusque collo
urn:cts:mid:catullus.35:10	ambas iniciens roget morari.
urn:cts:mid:catullus.35:11	quae nunc, si mihi vera nuntiantur,
urn:cts:mid:catullus.35:12	illum deperit impotente amore.
urn:cts:mid:catullus.35:13	nam quo tempore legit incohatam
urn:cts:mid:catullus.35:14	Dindymi dominam, ex eo misellae
urn:cts:mid:catullus.35:15	ignes interiorem edunt medullam.
urn:cts:mid:catullus.35:16	ignosco tibi, Sapphica puella
urn:cts:mid:catullus.35:17	musa doctior; est enim venuste
urn:cts:mid:catullus.35:18	Magna Caecilio incohata Mater.
urn:cts:mid:catullus.36:1	Annales Volusi, cacata carta,
urn:cts:mid:catullus.36:2	votum soluite pro mea puella.
urn:cts:mid:catullus.36:3	nam sanctae Veneri Cupidinique
urn:cts:mid:catullus.36:4	vovit, si sibi restitutus essem
urn:cts:mid:catullus.36:5	desissemque truces vibrare iambos,
urn:cts:mid:catullus.36:6	electissima pessimi poetae
urn:cts:mid:catullus.36:7	scripta tardipedi deo daturam
urn:cts:mid:catullus.36:8	infelicibus ustulanda lignis.
urn:cts:mid:catullus.36:9	et hoc pessima se puella vidit
urn:cts:mid:catullus.36:10	iocose lepide vovere divis.
urn:cts:mid:catullus.36:11	nunc o caeruleo creata ponto,
urn:cts:mid:catullus.36:12	quae sanctum Idalium Vriosque apertos
urn:cts:mid:catullus.36:13	quaeque Ancona Cnidumque harundinosam
urn:cts:mid:catullus.36:14	colis quaeque Amathunta quaeque Golgos
urn:cts:mid:catullus.36:15	quaeque Durrachium Hadriae tabernam,
urn:cts:mid:catullus.36:16	acceptum face redditumque votum,
urn:cts:mid:catullus.36:17	si non illepidum neque invenustum est.
urn:cts:mid:catullus.36:18	at vos interea venite in ignem,
urn:cts:mid:catullus.36:19	pleni ruris et inficetiarum.
urn:cts:mid:catullus.36:20	annales Volusi, cacata carta.
urn:cts:mid:catullus.37:1	Salax taberna vosque contubernales,
urn:cts:mid:catullus.37:2	a pilleatis nona fratribus pila,
urn:cts:mid:catullus.37:3	solis putatis esse mentulas vobis,
urn:cts:mid:catullus.37:4	solis licere, quidquid est puellarum,
urn:cts:mid:catullus.37:5	confutuere et putare ceteros hircos?
urn:cts:mid:catullus.37:6	an, continenter quod sedetis insulsi
urn:cts:mid:catullus.37:7	centum an ducenti, non putatis ausurum
urn:cts:mid:catullus.37:8	me una ducentos irrumare sessores?
urn:cts:mid:catullus.37:9	atqui putate: namque totius vobis
urn:cts:mid:catullus.37:10	frontem tabernae sopionibus scribam.
urn:cts:mid:catullus.37:11	puella nam mi, quae meo sinu fugit,
urn:cts:mid:catullus.37:12	amata tantum quantum amabitur nulla,
urn:cts:mid:catullus.37:13	pro qua mihi sunt magna bella pugnata,
urn:cts:mid:catullus.37:14	consedit istic. hanc boni beatique
urn:cts:mid:catullus.37:15	omnes amatis, et quidem, quod indignum est,
urn:cts:mid:catullus.37:16	omnes pusilli et semitarii moechi;
urn:cts:mid:catullus.37:17	tu praeter omnes une de capillatis,
urn:cts:mid:catullus.37:18	cuniculosae Celtiberiae fili,
urn:cts:mid:catullus.37:19	Egnati. opaca quem bonum facit barba
urn:cts:mid:catullus.37:20	et dens Hibera defricatus urina.
urn:cts:mid:catullus.38:1	Malest, Cornifici, tuo Catullo
urn:cts:mid:catullus.38:2	malest, me hercule, et laboriose,
urn:cts:mid:catullus.38:3	et magis magis in dies et horas.
urn:cts:mid:catullus.38:4	quem tu, quod minimum facillimumque est,
urn:cts:mid:catullus.38:5	qua solatus es allocutione?
urn:cts:mid:catullus.38:6	irascor tibi. sic meos amores?
urn:cts:mid:catullus.38:7	paulum quid lubet allocutionis,
urn:cts:mid:catullus.38:8	maestius lacrimis Simonideis.
urn:cts:mid:catullus.39:1	Egnatius, quod candidos habet dentes,
urn:cts:mid:catullus.39:2	renidet usque quaque. si ad rei ventum est
urn:cts:mid:catullus.39:3	subsellium, cum orator excitat fletum,
urn:cts:mid:catullus.39:4	renidet ille; si ad pii rogum fili
urn:cts:mid:catullus.39:5	lugetur, orba cum flet unicum mater,
urn:cts:mid:catullus.39:6	renidet ille. quidquid est, ubicumque est,
urn:cts:mid:catullus.39:7	quodcumque agit, renidet: hunc habet morbum,
urn:cts:mid:catullus.39:8	neque elegantem, ut arbitror, neque urbanum.
urn:cts:mid:catullus.39:9	quare monendum est te mihi, bone Egnati.
urn:cts:mid:catullus.39:10	si urbanus esses aut Sabinus aut Tiburs
urn:cts:mid:catullus.39:11	aut pinguis Vmber aut obesus Etruscus
urn:cts:mid:catullus.39:12	aut Lanuvinus ater atque dentatus
urn:cts:mid:catullus.39:13	aut Transpadanus, ut meos quoque attingam,
urn:cts:mid:catullus.39:14	aut quilubet, qui puriter lavit dentes,
urn:cts:mid:catullus.39:15	tamen renidere usque quaque te nollem:
urn:cts:mid:catullus.39:16	nam risu inepto res ineptior nulla est.
urn:cts:mid:catullus.39:17	nunc Celtiber es: Celtiberia in terra,
urn:cts:mid:catullus.39:18	quod quisque minxit, hoc sibi solet mane
urn:cts:mid:catullus.39:19	dentem atque russam defricare gingivam,
urn:cts:mid:catullus.39:20	ut quo iste vester expolitior dens est,
urn:cts:mid:catullus.39:21	hoc te amplius bibisse praedicet loti.
urn:cts:mid:catullus.4:1	Phaselus ille, quem videtis, hospites,
urn:cts:mid:catullus.4:2	ait fuisse navium celerrimus,
urn:cts:mid:catullus.4:3	neque ullius natantis impetum trabis
urn:cts:mid:catullus.4:4	nequisse praeterire, sive palmulis
urn:cts:mid:catullus.4:5	opus foret volare sive linteo.
urn:cts:mid:catullus.4:6	et hoc negat minacis Hadriatici
urn:cts:mid:catullus.4:7	negare litus insulasve Cycladas
urn:cts:mid:catullus.4:8	Rhodumque nobilem horridamque Thraciam
urn:cts:mid:catullus.4:9	Propontida trucemve Ponticum sinum,
urn:cts:mid:catullus.4:10	ubi iste post phaselus antea fuit
urn:cts:mid:catullus.4:11	comata silva; nam Cytorio in iugo
urn:cts:mid:catullus.4:12	loquente saepe sibilum edidit coma.
urn:cts:mid:catullus.4:13	Amastri Pontica et Cytore buxifer,
urn:cts:mid:catullus.4:14	tibi haec fuisse et esse cognitissima
urn:cts:mid:catullus.4:15	ait phaselus: ultima ex origine
urn:cts:mid:catullus.4:16	tuo stetisse dicit in cacumine,
urn:cts:mid:catullus.4:17	tuo imbuisse palmulas in aequore,
urn:cts:mid:catullus.4:18	et inde tot per impotentia freta
urn:cts:mid:catullus.4:19	erum tulisse, laeva sive dextera
urn:cts:mid:catullus.4:20	vocaret aura, sive utrumque Iuppiter
urn:cts:mid:catullus.4:21	simul secundus incidisset in pedem;
urn:cts:mid:catullus.4:22	neque ulla vota litoralibus deis
urn:cts:mid:catullus.4:23	sibi esse facta, cum veniret a mari
urn:cts:mid:catullus.4:24	novissimo hunc ad usque limpidum lacum.
urn:cts:mid:catullus.4:25	sed haec prius fuere: nunc recondita
urn:cts:mid:catullus.4:26	senet quiete seque dedicat tibi,
urn:cts:mid:catullus.4:27	gemelle Castor et gemelle Castoris.
urn:cts:mid:catullus.40:1	Quaenam te mala mens, miselle Ravide,
urn:cts:mid:catullus.40:2	agit praecipitem in meos iambos?
urn:cts:mid:catullus.40:3	quis deus tibi non bene advocatus
urn:cts:mid:catullus.40:4	vecordem parat excitare rixam?
urn:cts:mid:catullus.40:5	an ut pervenias in ora vulgi?
urn:cts:mid:catullus.40:6	quid vis? qualubet esse notus optas?
urn:cts:mid:catullus.40:7	eris, quandoquidem meos amores
urn:cts:mid:catullus.40:8	cum longa voluisti amare poena.
urn:cts:mid:catullus.41:1	Ameana puella defututa
urn:cts:mid:catullus.41:2	tota milia me decem poposcit,
urn:cts:mid:catullus.41:3	ista turpiculo puella naso,
urn:cts:mid:catullus.41:4	decoctoris amica Formiani.
urn:cts:mid:catullus.41:5	propinqui, quibus est puella curae,
urn:cts:mid:catullus.41:6	amicos medicosque convocate:
urn:cts:mid:catullus.41:7	non est sana puella, nec rogare
urn:cts:mid:catullus.41:8	qualis sit solet aes imaginosum.
urn:cts:mid:catullus.42:1	Adeste, hendecasyllabi, quot estis
urn:cts:mid:catullus.42:2	omnes undique, quotquot estis omnes.
urn:cts:mid:catullus.42:3	iocum me putat esse moecha turpis,
urn:cts:mid:catullus.42:4	et negat mihi nostra reddituram
urn:cts:mid:catullus.42:5	pugillaria, si pati potestis.
urn:cts:mid:catullus.42:6	persequamur eam et reflagitemus.
urn:cts:mid:catullus.42:7	quae sit, quaeritis? illa, quam videtis
urn:cts:mid:catullus.42:8	turpe incedere, mimice ac moleste
urn:cts:mid:catullus.42:9	ridentem catuli ore Gallicani.
urn:cts:mid:catullus.42:10	circumsistite eam, et reflagitate,
urn:cts:mid:catullus.42:11	'moecha putida, redde codicillos,
urn:cts:mid:catullus.42:12	redde putida moecha, codicillos!'
urn:cts:mid:catullus.42:13	non assis facis? o lutum, lupanar,
urn:cts:mid:catullus.42:14	aut si perditius potes quid esse.
urn:cts:mid:catullus.42:15	sed non est tamen hoc satis putandum.
urn:cts:mid:catullus.42:16	quod si non aliud potest ruborem
urn:cts:mid:catullus.42:17	ferreo canis exprimamus ore.
urn:cts:mid:catullus.42:18	conclamate iterum altiore voce.
urn:cts:mid:catullus.42:19	'moecha putide, redde codicillos,
urn:cts:mid:catullus.42:20	redde, putida moecha, codicillos!'
urn:cts:mid:catullus.42:21	sed nil proficimus, nihil movetur.
urn:cts:mid:catullus.42:22	mutanda est ratio modusque vobis,
urn:cts:mid:catullus.42:23	siquid proficere amplius potestis:
urn:cts:mid:catullus.42:24	'pudica et proba, redde codicillos.'
urn:cts:mid:catullus.43:1	Salve, nec minimo puella naso
urn:cts:mid:catullus.43:2	nec bello pede nec nigris ocellis
urn:cts:mid:catullus.43:3	nec longis digitis nec ore sicco
urn:cts:mid:catullus.43:4	nec sane nimis elegante lingua,
urn:cts:mid:catullus.43:5	decoctoris amica Formiani.
urn:cts:mid:catullus.43:6	ten provincia narrat esse bellam?
urn:cts:mid:catullus.43:7	tecum Lesbia nostra comparatur?
urn:cts:mid:catullus.43:8	o saeclum insapiens et infacetum!
urn:cts:mid:catullus.44:1	O Funde noster seu Sabine seu Tiburs
urn:cts:mid:catullus.44:2	(nam te esse Tiburtem autumant, quibus non est
urn:cts:mid:catullus.44:3	cordi Catullum laedere; at quibus cordi est,
urn:cts:mid:catullus.44:4	quovis Sabinum pignore esse contendunt),
urn:cts:mid:catullus.44:5	sed seu Sabine sive verius Tiburs,
urn:cts:mid:catullus.44:6	fui libenter in tua suburbana
urn:cts:mid:catullus.44:7	villa, malamque pectore expuli tussim,
urn:cts:mid:catullus.44:8	non inmerenti quam mihi meus venter,
urn:cts:mid:catullus.44:9	dum sumptuosas appeto, dedit, cenas.
urn:cts:mid:catullus.44:10	nam, Sestianus dum volo esse conviva,
urn:cts:mid:catullus.44:11	orationem in Antium petitorem
urn:cts:mid:catullus.44:12	plenam veneni et pestilentiae legi.
urn:cts:mid:catullus.44:13	hic me gravedo frigida et frequens tussis
urn:cts:mid:catullus.44:14	quassavit usque, dum in tuum sinum fugi,
urn:cts:mid:catullus.44:15	et me recuravi otioque et urtica.
urn:cts:mid:catullus.44:16	quare refectus maximas tibi grates
urn:cts:mid:catullus.44:17	ago, meum quod non es ulta peccatum.
urn:cts:mid:catullus.44:18	nec deprecor iam, si nefaria scripta
urn:cts:mid:catullus.44:19	Sesti recepso, quin gravedinem et tussim
urn:cts:mid:catullus.44:20	non mihi, sed ipsi Sestio ferat frigus,
urn:cts:mid:catullus.44:21	qui tunc vocat me, cum malum librum legi.
urn:cts:mid:catullus.45:1	Acmen Septimius suos amores
urn:cts:mid:catullus.45:2	tenens in gremio 'mea' inquit 'Acme,
urn:cts:mid:catullus.45:3	ni te perdite amo atque amare porro
urn:cts:mid:catullus.45:4	omnes sum assidve paratus annos,
urn:cts:mid:catullus.45:5	quantum qui pote plurimum perire,
urn:cts:mid:catullus.45:6	solus in Libya Indiaque tosta
urn:cts:mid:catullus.45:7	caesio veniam obvius leoni.'
urn:cts:mid:catullus.45:8	hoc ut dixit, Amor sinistra ut ante
urn:cts:mid:catullus.45:9	dextra sternuit approbationem.
urn:cts:mid:catullus.45:10	at Acme leviter caput reflectens
urn:cts:mid:catullus.45:11	et dulcis pueri ebrios ocellos
urn:cts:mid:catullus.45:12	illo purpureo ore suaviata,
urn:cts:mid:catullus.45:13	'sic' inquit 'mea vita Septimille,
urn:cts:mid:catullus.45:14	huic uni domino usque serviamus,
urn:cts:mid:catullus.45:15	ut multo mihi maior acriorque
urn:cts:mid:catullus.45:16	ignis mollibus ardet in medullis.'
urn:cts:mid:catullus.45:17	hoc ut dixit, Amor sinistra ut ante
urn:cts:mid:catullus.45:18	dextra sternuit approbationem.
urn:cts:mid:catullus.45:19	nunc ab auspicio bono profecti
urn:cts:mid:catullus.45:20	mutuis animis amant amantur.
urn:cts:mid:catullus.45:21	unam Septimius misellus Acmen
urn:cts:mid:catullus.45:22	mauult quam Syrias Britanniasque:
urn:cts:mid:catullus.45:23	uno in Septimio fidelis Acme
urn:cts:mid:catullus.45:24	facit delicias libidinisque.
urn:cts:mid:catullus.45:25	quis ullos homines beatiores
urn:cts:mid:catullus.45:26	vidit, quis Venerem auspicatiorem?
urn:cts:mid:catullus.46:1	Iam ver egelidos refert tepores,
urn:cts:mid:catullus.46:2	iam caeli furor aequinoctialis
urn:cts:mid:catullus.46:3	iucundis Zephyri silescit aureis.
urn:cts:mid:catullus.46:4	linquantur Phrygii, Catulle, campi
urn:cts:mid:catullus.46:5	Nicaeaeque ager uber aestuosae:
urn:cts:mid:catullus.46:6	ad claras Asiae volemus urbes.
urn:cts:mid:catullus.46:7	iam mens praetrepidans avet vagari,
urn:cts:mid:catullus.46:8	iam laeti studio pedes vigescunt.
urn:cts:mid:catullus.46:9	o dulces comitum valete coetus,
urn:cts:mid:catullus.46:10	longe quos simul a domo profectos
urn:cts:mid:catullus.46:11	diuersae varie viae reportant.
urn:cts:mid:catullus.47:1	Porci et Socration, duae sinistrae
urn:cts:mid:catullus.47:2	Pisonis, scabies famesque mundi,
urn:cts:mid:catullus.47:3	vos Veraniolo meo et Fabullo
urn:cts:mid:catullus.47:4	verpus praeposuit Priapus ille?
urn:cts:mid:catullus.47:5	vos convivia lauta sumptuose
urn:cts:mid:catullus.47:6	de die facitis, mei sodales
urn:cts:mid:catullus.47:7	quaerunt in triuio vocationes?
urn:cts:mid:catullus.48:1	Mellitos oculos tuos, Iuventi,
urn:cts:mid:catullus.48:2	si quis me sinat usque basiare,
urn:cts:mid:catullus.48:3	usque ad milia basiem trecenta
urn:cts:mid:catullus.48:4	nec numquam videar satur futurus,
urn:cts:mid:catullus.48:5	non si densior aridis aristis
urn:cts:mid:catullus.48:6	sit nostrae seges osculationis.
urn:cts:mid:catullus.49:1	Disertissime Romuli nepotum,
urn:cts:mid:catullus.49:2	quot sunt quotque fuere, Marce Tulli,
urn:cts:mid:catullus.49:3	quotque post aliis erunt in annis,
urn:cts:mid:catullus.49:4	gratias tibi maximas Catullus
urn:cts:mid:catullus.49:5	agit pessimus omnium poeta,
urn:cts:mid:catullus.49:6	tanto pessimus omnium poeta,
urn:cts:mid:catullus.49:7	quanto tu optimus omnium patronus.
urn:cts:mid:catullus.5:1	Vivamus mea Lesbia, atque amemus,
urn:cts:mid:catullus.5:2	rumoresque senum severiorum
urn:cts:mid:catullus.5:3	omnes unius aestimemus assis!
urn:cts:mid:catullus.5:4	soles occidere et redire possunt:
urn:cts:mid:catullus.5:5	nobis cum semel occidit brevis lux,
urn:cts:mid:catullus.5:6	nox est perpetua una dormienda.
urn:cts:mid:catullus.5:7	da mi basia mille, deinde centum,
urn:cts:mid:catullus.5:8	dein mille altera, dein secunda centum,
urn:cts:mid:catullus.5:9	deinde usque altera mille, deinde centum.
urn:cts:mid:catullus.5:10	dein, cum milia multa fecerimus,
urn:cts:mid:catullus.5:11	conturbabimus illa, ne sciamus,
urn:cts:mid:catullus.5:12	aut ne quis malus invidere possit,
urn:cts:mid:catullus.5:13	cum tantum sciat esse basiorum.
urn:cts:mid:catullus.50:1	Hesterno, Licini, die otiosi
urn:cts:mid:catullus.50:2	multum lusimus in meis tabellis,
urn:cts:mid:catullus.50:3	ut convenerat esse delicatos:
urn:cts:mid:catullus.50:4	scribens versiculos uterque nostrum
urn:cts:mid:catullus.50:5	ludebat numero modo hoc modo illoc,
urn:cts:mid:catullus.50:6	reddens mutua per iocum atque vinum.
urn:cts:mid:catullus.50:7	atque illinc abii tuo lepore
urn:cts:mid:catullus.50:8	incensus, Licini, facetiisque,
urn:cts:mid:catullus.50:9	ut nec me miserum cibus iuvaret
urn:cts:mid:catullus.50:10	nec somnus tegeret quiete ocellos,
urn:cts:mid:catullus.50:11	sed toto indomitus furore lecto
urn:cts:mid:catullus.50:12	versarer, cupiens videre lucem,
urn:cts:mid:catullus.50:13	ut tecum loquerer, simulque ut essem.
urn:cts:mid:catullus.50:14	at defessa labore membra postquam
urn:cts:mid:catullus.50:15	semimortua lectulo iacebant,
urn:cts:mid:catullus.50:16	hoc, iucunde, tibi poema feci,
urn:cts:mid:catullus.50:17	ex quo perspiceres meum dolorem.
urn:cts:mid:catullus.50:18	nunc audax cave sis, precesque nostras,
urn:cts:mid:catullus.50:19	oramus, cave despuas, ocelle,
urn:cts:mid:catullus.50:20	ne poenas Nemesis reposcat a te.
urn:cts:mid:catullus.50:21	est vehemens dea: laedere hanc caveto.
urn:cts:mid:catullus.51:1	Ille mi par esse deo videtur,
urn:cts:mid:catullus.51:2	ille, si fas est, superare divos,
urn:cts:mid:catullus.51:3	qui sedens adversus identidem te
urn:cts:mid:catullus.51:4	spectat et audit
urn:cts:mid:catullus.51:5	dulce ridentem, misero quod omnis
urn:cts:mid:catullus.51:6	eripit sensus mihi: nam simul te,
urn:cts:mid:catullus.51:7	Lesbia, aspexi, nihil est super mi
urn:cts:mid:catullus.51:8	* * * * * * * *
urn:cts:mid:catullus.51:9	lingua sed torpet, tenuis sub artus
urn:cts:mid:catullus.51:10	flamma demanat, sonitu suopte
urn:cts:mid:catullus.51:11	tintinant aures gemina, teguntur
urn:cts:mid:catullus.51:12	lumina nocte.
urn:cts:mid:catullus.51:13	otium, Catulle, tibi molestum est:
urn:cts:mid:catullus.51:14	otio exsultas nimiumque gestis:
urn:cts:mid:catullus.51:15	otium et reges prius et beatas
urn:cts:mid:catullus.51:16	perdidit urbes.
urn:cts:mid:catullus.52:1	Quid est, Catulle? quid moraris emori?
urn:cts:mid:catullus.52:2	sella in curuli struma Nonius sedet,
urn:cts:mid:catullus.52:3	per consulatum peierat Vatinius:
urn:cts:mid:catullus.52:4	quid est, Catulle? quid moraris emori?
urn:cts:mid:catullus.53:1	Risi nescio quem modo e corona,
urn:cts:mid:catullus.53:2	qui, cum mirifice Vatiniana
urn:cts:mid:catullus.53:3	meus crimina Caluos explicasset
urn:cts:mid:catullus.53:4	admirans ait haec manusque tollens,
urn:cts:mid:catullus.53:5	'di magni, salaputium disertum!'
urn:cts:mid:catullus.54:1	Othonis caput oppido est pusillum,
urn:cts:mid:catullus.54:2	et eri rustice semilauta crura,
urn:cts:mid:catullus.54:3	subtile et leve peditum Libonis,
urn:cts:mid:catullus.54:4	si non omnia, displicere vellem
urn:cts:mid:catullus.54:5	tibi et Sufficio seni recocto...
urn:cts:mid:catullus.54:6	irascere iterum meis iambis
urn:cts:mid:catullus.54:7	inmerentibus, unice imperator.
urn:cts:mid:catullus.55:1	Oramus, si forte non molestum est,
urn:cts:mid:catullus.55:2	demonstres ubi sint tuae tenebrae.
urn:cts:mid:catullus.55:3	te Campo quaesivimus minore,
urn:cts:mid:catullus.55:4	te in Circo, te in omnibus libellis,
urn:cts:mid:catullus.55:5	te in templo summi Iovis sacrato.
urn:cts:mid:catullus.55:6	in Magni simul ambulatione
urn:cts:mid:catullus.55:7	femellas omnes, amice, prendi,
urn:cts:mid:catullus.55:8	quas vultu vidi tamen sereno.
urn:cts:mid:catullus.55:9	avelte, sic ipse flagitabam,
urn:cts:mid:catullus.55:10	Camerium mihi pessimae puellae.
urn:cts:mid:catullus.55:11	quaedam inquit, nudum reduc...
urn:cts:mid:catullus.55:12	'en hic in roseis latet papillis.'
urn:cts:mid:catullus.55:13	sed te iam ferre Herculi labos est;
urn:cts:mid:catullus.55:14	tanto te in fastu negas, amice.
urn:cts:mid:catullus.55:15	dic nobis ubi sis futurus, ede
urn:cts:mid:catullus.55:16	audacter, committe, crede luci.
urn:cts:mid:catullus.55:17	nunc te lacteolae tenent puellae?
urn:cts:mid:catullus.55:18	si linguam clauso tenes in ore,
urn:cts:mid:catullus.55:19	fructus proicies amoris omnes.
urn:cts:mid:catullus.55:20	verbosa gaudet Venus loquella.
urn:cts:mid:catullus.55:21	vel, si vis, licet obseres palatum,
urn:cts:mid:catullus.55:22	dum vestri sim particeps amoris.
urn:cts:mid:catullus.56:1	O rem ridiculam, Cato, et iocosam,
urn:cts:mid:catullus.56:2	dignamque auribus et tuo cachinno!
urn:cts:mid:catullus.56:3	ride quidquid amas, Cato, Catullum:
urn:cts:mid:catullus.56:4	res est ridicula et nimis iocosa.
urn:cts:mid:catullus.56:5	deprendi modo pupulum puellae
urn:cts:mid:catullus.56:6	trusantem; hunc ego, si placet Dionae,
urn:cts:mid:catullus.56:7	protelo rigida mea cecidi.
urn:cts:mid:catullus.57:1	Pulcre convenit improbis cinaedis,
urn:cts:mid:catullus.57:2	Mamurrae pathicoque Caesarique.
urn:cts:mid:catullus.57:3	nec mirum: maculae pares utrisque,
urn:cts:mid:catullus.57:4	urbana altera et illa Formiana,
urn:cts:mid:catullus.57:5	impressae resident nec eluentur:
urn:cts:mid:catullus.57:6	morbosi pariter, gemelli utrique,
urn:cts:mid:catullus.57:7	uno in lecticulo erudituli ambo,
urn:cts:mid:catullus.57:8	non hic quam ille magis vorax adulter,
urn:cts:mid:catullus.57:9	rivales socii puellularum.
urn:cts:mid:catullus.57:10	pulcre convenit improbis cinaedis.
urn:cts:mid:catullus.58:1	Caeli, Lesbia nostra, Lesbia illa.
urn:cts:mid:catullus.58:2	illa Lesbia, quam Catullus unam
urn:cts:mid:catullus.58:3	plus quam se atque suos amavit omnes,
urn:cts:mid:catullus.58:4	nunc in quadriviis et angiportis
urn:cts:mid:catullus.58:5	glubit magnanimi Remi nepotes.
urn:cts:mid:catullus.58b:1	Non custos si fingar ille Cretum,
urn:cts:mid:catullus.58b:2	non Ladas ego pinnipesve Perseus,
urn:cts:mid:catullus.58b:3	non si Pegaseo ferar volatu,
urn:cts:mid:catullus.58b:4	non Rhesi niveae citaeque bigae;
urn:cts:mid:catullus.58b:5	adde huc plumipedas volatilesque,
urn:cts:mid:catullus.58b:6	ventorumque simul require cursum,
urn:cts:mid:catullus.58b:7	quos iunctos, Cameri, mihi dicares:
urn:cts:mid:catullus.58b:8	defessus tamen omnibus medullis
urn:cts:mid:catullus.58b:9	et multis languoribus peresus
urn:cts:mid:catullus.58b:10	essem te mihi, amice, quaeritando.
urn:cts:mid:catullus.59:1	Bononiensis Rufa Rufulum fellat,
urn:cts:mid:catullus.59:2	uxor Meneni, saepe quam in sepulcretis
urn:cts:mid:catullus.59:3	vidistis ipso rapere de rogo cenam,
urn:cts:mid:catullus.59:4	cum devolutum ex igne prosequens panem
urn:cts:mid:catullus.59:5	ab semiraso tunderetur ustore.
urn:cts:mid:catullus.6:1	Flavi, delicias tuas Catullo,
urn:cts:mid:catullus.6:2	ni sint illepidae atque inelegantes,
urn:cts:mid:catullus.6:3	velles dicere nec tacere posses.
urn:cts:mid:catullus.6:4	verum nescio quid febriculosi
urn:cts:mid:catullus.6:5	scorti diligis: hoc pudet fateri.
urn:cts:mid:catullus.6:6	nam te non viduas iacere noctes
urn:cts:mid:catullus.6:7	nequiquam tacitum cubile clamat
urn:cts:mid:catullus.6:8	sertis ac Syrio fragrans olivo,
urn:cts:mid:catullus.6:9	pulvinusque peraeque et hic et ille
urn:cts:mid:catullus.6:10	attritus, tremulique quassa lecti
urn:cts:mid:catullus.6:11	argutatio inambulatioque.
urn:cts:mid:catullus.6:12	nam inista prevalet nihil tacere.
urn:cts:mid:catullus.6:13	cur? non tam latera ecfututa pandas,
urn:cts:mid:catullus.6:14	ni tu quid facias ineptiarum.
urn:cts:mid:catullus.6:15	quare, quidquid habes boni malique,
urn:cts:mid:catullus.6:16	dic nobis. volo te ac tuos amores
urn:cts:mid:catullus.6:17	ad caelum lepido vocare versu.
urn:cts:mid:catullus.60:1	Num te leaena montibus Libystinis
urn:cts:mid:catullus.60:2	aut Scylla latrans infima inguinum parte
urn:cts:mid:catullus.60:3	tam mente dura procreavit ac taetra,
urn:cts:mid:catullus.60:4	ut supplicis vocem in novissimo casu
urn:cts:mid:catullus.60:5	contemptam haberes, a nimis fero corde?
urn:cts:mid:catullus.61:1	Collis o Heliconii
urn:cts:mid:catullus.61:2	cultor, Uraniae genus,
urn:cts:mid:catullus.61:3	qui rapis teneram ad virum
urn:cts:mid:catullus.61:4	virginem, o Hymenaee Hymen,
urn:cts:mid:catullus.61:5	o Hymen Hymenaee;
urn:cts:mid:catullus.61:6	
urn:cts:mid:catullus.61:7	cinge tempora floribus
urn:cts:mid:catullus.61:8	suave olentis amaraci,
urn:cts:mid:catullus.61:9	flammeum cape laetus, huc
urn:cts:mid:catullus.61:10	huc veni, niveo gerens
urn:cts:mid:catullus.61:11	luteum pede soccum;
urn:cts:mid:catullus.61:12	
urn:cts:mid:catullus.61:13	excitusque hilari die,
urn:cts:mid:catullus.61:14	nuptialia concinens
urn:cts:mid:catullus.61:15	voce carmina tinnula,
urn:cts:mid:catullus.61:16	pelle humum pedibus, manu
urn:cts:mid:catullus.61:17	pineam quate taedam.
urn:cts:mid:catullus.61:18	
urn:cts:mid:catullus.61:19	namque Iunia Manlio,
urn:cts:mid:catullus.61:20	qualis Idalium colens
urn:cts:mid:catullus.61:21	venit ad Phrygium Venus
urn:cts:mid:catullus.61:22	iudicem, bona cum bona
urn:cts:mid:catullus.61:23	nubet alite virgo,
urn:cts:mid:catullus.61:24	
urn:cts:mid:catullus.61:25	floridis velut enitens
urn:cts:mid:catullus.61:26	myrtus Asia ramulis
urn:cts:mid:catullus.61:27	quos Hamadryades deae
urn:cts:mid:catullus.61:28	ludicrum sibi roscido
urn:cts:mid:catullus.61:29	nutriunt umore.
urn:cts:mid:catullus.61:30	
urn:cts:mid:catullus.61:31	quare age, huc aditum ferens,
urn:cts:mid:catullus.61:32	perge linquere Thespiae
urn:cts:mid:catullus.61:33	rupis Aonios specus,
urn:cts:mid:catullus.61:34	nympha quos super irrigat
urn:cts:mid:catullus.61:35	frigerans Aganippe.
urn:cts:mid:catullus.61:36	
urn:cts:mid:catullus.61:37	ac domum dominam voca
urn:cts:mid:catullus.61:38	coniugis cupidam novi,
urn:cts:mid:catullus.61:39	mentem amore revinciens,
urn:cts:mid:catullus.61:40	ut tenax hedera huc et huc
urn:cts:mid:catullus.61:41	arborem implicat errans.
urn:cts:mid:catullus.61:42	
urn:cts:mid:catullus.61:43	vosque item simul, integrae
urn:cts:mid:catullus.61:44	virgines, quibus advenit
urn:cts:mid:catullus.61:45	par dies, agite in modum
urn:cts:mid:catullus.61:46	dicite, o Hymenaee Hymen,
urn:cts:mid:catullus.61:47	o Hymen Hymenaee.
urn:cts:mid:catullus.61:48	
urn:cts:mid:catullus.61:49	ut libentius, audiens
urn:cts:mid:catullus.61:50	se citarier ad suum
urn:cts:mid:catullus.61:51	munus, huc aditum ferat
urn:cts:mid:catullus.61:52	dux bonae Veneris, boni
urn:cts:mid:catullus.61:53	coniugator amoris.
urn:cts:mid:catullus.61:54	
urn:cts:mid:catullus.61:55	quis deus magis est ama-
urn:cts:mid:catullus.61:56	tis petendus amantibus?
urn:cts:mid:catullus.61:57	quem colent homines magis
urn:cts:mid:catullus.61:58	caelitum, o Hymenaee Hymen,
urn:cts:mid:catullus.61:59	o Hymen Hymenaee?
urn:cts:mid:catullus.61:60	
urn:cts:mid:catullus.61:61	te suis tremulus parens
urn:cts:mid:catullus.61:62	invocat, tibi virgines
urn:cts:mid:catullus.61:63	zonula solvunt sinus,
urn:cts:mid:catullus.61:64	te timens cupida novos
urn:cts:mid:catullus.61:65	captat aure maritus.
urn:cts:mid:catullus.61:66	
urn:cts:mid:catullus.61:67	tu fero iuveni in manus
urn:cts:mid:catullus.61:68	floridam ipse puellulam
urn:cts:mid:catullus.61:69	dedis a gremio suae
urn:cts:mid:catullus.61:70	matris, o Hymenaee Hymen,
urn:cts:mid:catullus.61:71	o Hymen Hymenaee.
urn:cts:mid:catullus.61:72	
urn:cts:mid:catullus.61:73	nil potest sine te Venus,
urn:cts:mid:catullus.61:74	fama quod bona comprobet,
urn:cts:mid:catullus.61:75	commodi capere, at potest
urn:cts:mid:catullus.61:76	te volente. quis huic deo
urn:cts:mid:catullus.61:77	compararier ausit?
urn:cts:mid:catullus.61:78	
urn:cts:mid:catullus.61:79	nulla quit sine te domus
urn:cts:mid:catullus.61:80	liberos dare, nec parens
urn:cts:mid:catullus.61:81	stirpe nitier; ac potest
urn:cts:mid:catullus.61:82	te volente. quis huic deo
urn:cts:mid:catullus.61:83	compararier ausit?
urn:cts:mid:catullus.61:84	
urn:cts:mid:catullus.61:85	quae tuis careat sacris,
urn:cts:mid:catullus.61:86	non queat dare praesides
urn:cts:mid:catullus.61:87	terra finibus: at queat
urn:cts:mid:catullus.61:88	te volente. quis huic deo
urn:cts:mid:catullus.61:89	compararier ausit?
urn:cts:mid:catullus.61:90	
urn:cts:mid:catullus.61:91	claustra pandite ianuae.
urn:cts:mid:catullus.61:92	virgo adest. viden ut faces
urn:cts:mid:catullus.61:93	splendidas quatiunt comas?
urn:cts:mid:catullus.61:94	* * * * * * * * 
urn:cts:mid:catullus.61:95	* * * * * * * * 
urn:cts:mid:catullus.61:96	* * * * * * * * 
urn:cts:mid:catullus.61:97	* * * * * * * * 
urn:cts:mid:catullus.61:98	tardet ingenuus pudor.
urn:cts:mid:catullus.61:99	quem tamen magis audiens,
urn:cts:mid:catullus.61:100	flet quod ire necesse est.
urn:cts:mid:catullus.61:101	flere desine. non tibi Au-
urn:cts:mid:catullus.61:102	runculeia periculum est,
urn:cts:mid:catullus.61:103	ne qua femina pulcrior
urn:cts:mid:catullus.61:104	clarum ab Oceano diem
urn:cts:mid:catullus.61:105	uiderit venientem.
urn:cts:mid:catullus.61:106	
urn:cts:mid:catullus.61:107	talis in vario solet
urn:cts:mid:catullus.61:108	divitis domini hortulo
urn:cts:mid:catullus.61:109	stare flos hyacinthinus.
urn:cts:mid:catullus.61:110	sed moraris, abit dies.
urn:cts:mid:catullus.61:111	prodeas nova nupta.
urn:cts:mid:catullus.61:112	
urn:cts:mid:catullus.61:113	prodeas nova nupta, si
urn:cts:mid:catullus.61:114	iam videtur, et audias
urn:cts:mid:catullus.61:115	nostra verba. viden? faces
urn:cts:mid:catullus.61:116	aureas quatiunt comas:
urn:cts:mid:catullus.61:117	prodeas nova nupta.
urn:cts:mid:catullus.61:118	
urn:cts:mid:catullus.61:119	non tuus levis in mala
urn:cts:mid:catullus.61:120	deditus vir adultera,
urn:cts:mid:catullus.61:121	probra turpia persequens,
urn:cts:mid:catullus.61:122	a tuis teneris volet
urn:cts:mid:catullus.61:123	secubare papillis,
urn:cts:mid:catullus.61:124	
urn:cts:mid:catullus.61:125	lenta sed velut adsitas
urn:cts:mid:catullus.61:126	vitis implicat arbores,
urn:cts:mid:catullus.61:127	implicabitur in tuum
urn:cts:mid:catullus.61:128	complexum. sed abit dies:
urn:cts:mid:catullus.61:129	prodeas nova nupta.
urn:cts:mid:catullus.61:130	
urn:cts:mid:catullus.61:131	o cubile, quod omnibus
urn:cts:mid:catullus.61:132	* * * * * * * * 
urn:cts:mid:catullus.61:133	* * * * * * * * 
urn:cts:mid:catullus.61:134	* * * * * * * * 
urn:cts:mid:catullus.61:135	candido pede lecti,
urn:cts:mid:catullus.61:136	
urn:cts:mid:catullus.61:137	quae tuo veniunt ero,
urn:cts:mid:catullus.61:138	quanta gaudia, quae vaga
urn:cts:mid:catullus.61:139	nocte, quae medio die
urn:cts:mid:catullus.61:140	gaudeat! sed abit dies:
urn:cts:mid:catullus.61:141	prodeas nova nupta.
urn:cts:mid:catullus.61:142	
urn:cts:mid:catullus.61:143	tollite, o pueri, faces:
urn:cts:mid:catullus.61:144	flammeum video venire.
urn:cts:mid:catullus.61:145	ite concinite in modum
urn:cts:mid:catullus.61:146	'io Hymen Hymenaee io,
urn:cts:mid:catullus.61:147	io Hymen Hymenaee.'
urn:cts:mid:catullus.61:148	
urn:cts:mid:catullus.61:149	ne diu taceat procax
urn:cts:mid:catullus.61:150	Fescennina iocatio,
urn:cts:mid:catullus.61:151	nec nuces pueris neget
urn:cts:mid:catullus.61:152	desertum domini audiens
urn:cts:mid:catullus.61:153	concubinus amorem.
urn:cts:mid:catullus.61:154	
urn:cts:mid:catullus.61:155	da nuces pueris, iners
urn:cts:mid:catullus.61:156	concubine! satis diu
urn:cts:mid:catullus.61:157	lusisti nucibus: lubet
urn:cts:mid:catullus.61:158	iam servire Talasio.
urn:cts:mid:catullus.61:159	concubine, nuces da.
urn:cts:mid:catullus.61:160	
urn:cts:mid:catullus.61:161	sordebant tibi villicae,
urn:cts:mid:catullus.61:162	concubine, hodie atque heri:
urn:cts:mid:catullus.61:163	nunc tuum cinerarius
urn:cts:mid:catullus.61:164	tondet os. miser a miser
urn:cts:mid:catullus.61:165	concubine, nuces da.
urn:cts:mid:catullus.61:166	
urn:cts:mid:catullus.61:167	diceris male te a tuis
urn:cts:mid:catullus.61:168	unguentate glabris marite
urn:cts:mid:catullus.61:169	abstinere, sed abstine.
urn:cts:mid:catullus.61:170	io Hymen Hymenaee io,
urn:cts:mid:catullus.61:171	io Hymen Hymenaee.
urn:cts:mid:catullus.61:172	
urn:cts:mid:catullus.61:173	scimus haec tibi quae licent
urn:cts:mid:catullus.61:174	sola cognita, sed marito
urn:cts:mid:catullus.61:175	ista non eadem licent.
urn:cts:mid:catullus.61:176	io Hymen Hymenaee io,
urn:cts:mid:catullus.61:177	io Hymen Hymenaee.
urn:cts:mid:catullus.61:178	
urn:cts:mid:catullus.61:179	nupta, tu quoque quae tuus
urn:cts:mid:catullus.61:180	vir petet cave ne neges,
urn:cts:mid:catullus.61:181	ni petitum aliunde eat.
urn:cts:mid:catullus.61:182	io Hymen Hymenaee io,
urn:cts:mid:catullus.61:183	io Hymen Hymenaee.
urn:cts:mid:catullus.61:184	
urn:cts:mid:catullus.61:185	en tibi domus ut potens
urn:cts:mid:catullus.61:186	et beata viri tui,
urn:cts:mid:catullus.61:187	quae tibi sine serviat
urn:cts:mid:catullus.61:188	(io Hymen Hymenaee io,
urn:cts:mid:catullus.61:189	io Hymen Hymenaee)
urn:cts:mid:catullus.61:190	
urn:cts:mid:catullus.61:191	usque dum tremulum movens
urn:cts:mid:catullus.61:192	cana tempus anilitas
urn:cts:mid:catullus.61:193	omnia omnibus annuit.
urn:cts:mid:catullus.61:194	io Hymen Hymenaee io,
urn:cts:mid:catullus.61:195	io Hymen Hymenaee.
urn:cts:mid:catullus.61:196	
urn:cts:mid:catullus.61:197	transfer omine cum bono
urn:cts:mid:catullus.61:198	limen aureolos pedes,
urn:cts:mid:catullus.61:199	rasilemque subi forem.
urn:cts:mid:catullus.61:200	io Hymen Hymenaee io,
urn:cts:mid:catullus.61:201	io Hymen Hymenaee.
urn:cts:mid:catullus.61:202	
urn:cts:mid:catullus.61:203	aspice intus ut accubans
urn:cts:mid:catullus.61:204	vir tuus Tyrio in toro
urn:cts:mid:catullus.61:205	totus immineat tibi.
urn:cts:mid:catullus.61:206	io Hymen Hymenaee io,
urn:cts:mid:catullus.61:207	io Hymen Hymenaee.
urn:cts:mid:catullus.61:208	
urn:cts:mid:catullus.61:209	illi non minus ac tibi
urn:cts:mid:catullus.61:210	pectore uritur intimo
urn:cts:mid:catullus.61:211	flamma, sed penite magis.
urn:cts:mid:catullus.61:212	io Hymen Hymenaee io,
urn:cts:mid:catullus.61:213	io Hymen Hymenaee.
urn:cts:mid:catullus.61:214	
urn:cts:mid:catullus.61:215	mitte brachiolum teres,
urn:cts:mid:catullus.61:216	praetextate, puellulae:
urn:cts:mid:catullus.61:217	iam cubile adeat viri.
urn:cts:mid:catullus.61:218	io Hymen Hymenaee io,
urn:cts:mid:catullus.61:219	io Hymen Hymenaee.
urn:cts:mid:catullus.61:220	
urn:cts:mid:catullus.61:221	vos bonae senibus viris
urn:cts:mid:catullus.61:222	cognitae bene feminae,
urn:cts:mid:catullus.61:223	collocate puellulam.
urn:cts:mid:catullus.61:224	io Hymen Hymenaee io,
urn:cts:mid:catullus.61:225	io Hymen Hymenaee.
urn:cts:mid:catullus.61:226	
urn:cts:mid:catullus.61:227	iam licet venias, marite:
urn:cts:mid:catullus.61:228	uxor in thalamo tibi est,
urn:cts:mid:catullus.61:229	ore floridulo nitens,
urn:cts:mid:catullus.61:230	alba parthenice velut
urn:cts:mid:catullus.61:231	luteumve papaver.
urn:cts:mid:catullus.61:232	
urn:cts:mid:catullus.61:233	at, marite, ita me iuvent
urn:cts:mid:catullus.61:234	caelites, nihilo minus
urn:cts:mid:catullus.61:235	pulcer es, neque te Venus
urn:cts:mid:catullus.61:236	neglegit. sed abit dies:
urn:cts:mid:catullus.61:237	perge, ne remorare.
urn:cts:mid:catullus.61:238	
urn:cts:mid:catullus.61:239	non diu remoratus es:
urn:cts:mid:catullus.61:240	iam venis. bona te Venus
urn:cts:mid:catullus.61:241	iuuerit, quoniam palam
urn:cts:mid:catullus.61:242	quod cupis cupis, et bonum
urn:cts:mid:catullus.61:243	non abscondis amorem.
urn:cts:mid:catullus.61:244	
urn:cts:mid:catullus.61:245	ille pulueris Africi
urn:cts:mid:catullus.61:246	siderumque micantium
urn:cts:mid:catullus.61:247	subducat numerum prius,
urn:cts:mid:catullus.61:248	qui vestri numerare vult
urn:cts:mid:catullus.61:249	multa milia ludi.
urn:cts:mid:catullus.61:250	
urn:cts:mid:catullus.61:251	ludite ut lubet, et brevi
urn:cts:mid:catullus.61:252	liberos date. non decet
urn:cts:mid:catullus.61:253	tam vetus sine liberis
urn:cts:mid:catullus.61:254	nomen esse, sed indidem
urn:cts:mid:catullus.61:255	semper ingenerari.
urn:cts:mid:catullus.61:256	
urn:cts:mid:catullus.61:257	Torquatus volo parvulus
urn:cts:mid:catullus.61:258	matris e gremio suae
urn:cts:mid:catullus.61:259	porrigens teneras manus
urn:cts:mid:catullus.61:260	dulce rideat ad patrem
urn:cts:mid:catullus.61:261	semihiante labello.
urn:cts:mid:catullus.61:262	
urn:cts:mid:catullus.61:263	sit suo similis patri
urn:cts:mid:catullus.61:264	Manlio et facile insciis
urn:cts:mid:catullus.61:265	noscitetur ab omnibus,
urn:cts:mid:catullus.61:266	et pudicitiam suae
urn:cts:mid:catullus.61:267	matris indicet ore.
urn:cts:mid:catullus.61:268	
urn:cts:mid:catullus.61:269	talis illius a bona
urn:cts:mid:catullus.61:270	matre laus genus approbet,
urn:cts:mid:catullus.61:271	qualis unica ab optima
urn:cts:mid:catullus.61:272	matre Telemacho manet
urn:cts:mid:catullus.61:273	fama Penelopeo.
urn:cts:mid:catullus.61:274	
urn:cts:mid:catullus.61:275	claudite ostia, virgines:
urn:cts:mid:catullus.61:276	lusimus satis. at boni
urn:cts:mid:catullus.61:277	coniuges, bene vivite et
urn:cts:mid:catullus.61:278	munere assiduo valentem
urn:cts:mid:catullus.61:279	exercete iuventam.
urn:cts:mid:catullus.62:1	Vesper adest, iuvenes, consurgite: Vesper Olympo
urn:cts:mid:catullus.62:2	exspectata diu vix tandem lumina tollit.
urn:cts:mid:catullus.62:3	surgere iam tempus, iam pinguis linquere mensas,
urn:cts:mid:catullus.62:4	iam veniet virgo, iam dicetur hymenaeus.
urn:cts:mid:catullus.62:5	Hymen o Hymenaee, Hymen ades o Hymenaee!
urn:cts:mid:catullus.62:6	Cernitis, innuptae, iuvenes? consurgite contra;
urn:cts:mid:catullus.62:7	nimirum Oetaeos ostendit Noctifer ignes.
urn:cts:mid:catullus.62:8	sic certest; viden ut perniciter exsiluere?
urn:cts:mid:catullus.62:9	non temere exsiluere, canent quod vincere par est.
urn:cts:mid:catullus.62:10	Hymen o Hymenaee, Hymen ades o Hymenaee!
urn:cts:mid:catullus.62:11	non facilis nobis, aequales, palma parata est:
urn:cts:mid:catullus.62:12	aspicite, innuptae secum ut meditata requirunt.
urn:cts:mid:catullus.62:13	non frustra meditantur: habent memorabile quod sit;
urn:cts:mid:catullus.62:14	nec mirum, penitus quae tota mente laborant.
urn:cts:mid:catullus.62:15	nos alio mentes, alio divisimus aures;
urn:cts:mid:catullus.62:16	iure igitur vincemur: amat victoria curam.
urn:cts:mid:catullus.62:17	quare nunc animos saltem convertite vestros;
urn:cts:mid:catullus.62:18	dicere iam incipient, iam respondere decebit.
urn:cts:mid:catullus.62:19	Hymen o Hymenaee, Hymen ades o Hymenaee!
urn:cts:mid:catullus.62:20	Hespere, quis caelo fertur crudelior ignis?
urn:cts:mid:catullus.62:21	qui natam possis complexu avellere matris,
urn:cts:mid:catullus.62:22	complexu matris retinentem avellere natam,
urn:cts:mid:catullus.62:23	et iuveni ardenti castam donare puellam.
urn:cts:mid:catullus.62:24	quid faciunt hostes capta crudelius urbe?
urn:cts:mid:catullus.62:25	Hymen o Hymenaee, Hymen ades o Hymenaee!
urn:cts:mid:catullus.62:26	Hespere, quis caelo lucet iucundior ignis?
urn:cts:mid:catullus.62:27	qui desponsa tua firmes conubia flamma,
urn:cts:mid:catullus.62:28	quae pepigere viri, pepigerunt ante parentes,
urn:cts:mid:catullus.62:29	nec iunxere prius quam se tuus extulit ardor.
urn:cts:mid:catullus.62:30	quid datur a divis felici optatius hora?
urn:cts:mid:catullus.62:31	Hymen o Hymenaee, Hymen ades o Hymenaee!
urn:cts:mid:catullus.62:32	Hesperus e nobis, aequales, abstulit unam.
urn:cts:mid:catullus.62:33	* * * * * * * * 
urn:cts:mid:catullus.62:34	* * * * * * * * 
urn:cts:mid:catullus.62:35	namque tuo adventu vigilat custodia semper,
urn:cts:mid:catullus.62:36	nocte latent fures, quos idem saepe reuertens,
urn:cts:mid:catullus.62:37	Hespere, mutato comprendis nomine Eous
urn:cts:mid:catullus.62:38	at lubet innuptis ficto te carpere questu.
urn:cts:mid:catullus.62:39	quid tum, si carpunt, tacita quem mente requirunt?
urn:cts:mid:catullus.62:40	Hymen o Hymenaee, Hymen ades o Hymenaee!
urn:cts:mid:catullus.62:41	Ut flos in saeptis secretus nascitur hortis,
urn:cts:mid:catullus.62:42	ignotus pecori, nullo convolsus aratro,
urn:cts:mid:catullus.62:43	quem mulcent aurae, firmat sol, educat imber;
urn:cts:mid:catullus.62:44	multi illum pueri, multae optavere puellae:
urn:cts:mid:catullus.62:45	idem cum tenui carptus defloruit ungui,
urn:cts:mid:catullus.62:46	nulli illum pueri, nullae optavere puellae:
urn:cts:mid:catullus.62:47	sic virgo, dum intacta manet, dum cara suis est;
urn:cts:mid:catullus.62:48	cum castum amisit polluto corpore florem,
urn:cts:mid:catullus.62:49	nec pueris iucunda manet, nec cara puellis.
urn:cts:mid:catullus.62:50	Hymen o Hymenaee, Hymen ades o Hymenaee!
urn:cts:mid:catullus.62:51	Ut vidua in nudo vitis quae nascitur aruo,
urn:cts:mid:catullus.62:52	numquam se extollit, numquam mitem educat uvam,
urn:cts:mid:catullus.62:53	sed tenerum prono deflectens pondere corpus
urn:cts:mid:catullus.62:54	iam iam contingit summum radice flagellum;
urn:cts:mid:catullus.62:55	hanc nulli agricolae, nulli coluere iuvenci:
urn:cts:mid:catullus.62:56	at si forte eadem est ulmo coniuncta marito,
urn:cts:mid:catullus.62:57	multi illam agricolae, multi coluere iuvenci:
urn:cts:mid:catullus.62:58	sic virgo dum intacta manet, dum inculta senescit;
urn:cts:mid:catullus.62:59	cum par conubium maturo tempore adepta est,
urn:cts:mid:catullus.62:60	cara viro magis et minus est invisa parenti.
urn:cts:mid:catullus.62:61	Hymen o Hymenaee, Hymen ades o Hymenaee!
urn:cts:mid:catullus.62:62	Et tu ne pugna cum tali coniuge virgo.
urn:cts:mid:catullus.62:63	non aequom est pugnare, pater cui tradidit ipse,
urn:cts:mid:catullus.62:64	ipse pater cum matre, quibus parere necesse est.
urn:cts:mid:catullus.62:65	virginitas non tota tua est, ex parte parentum est,
urn:cts:mid:catullus.62:66	tertia pars patrest, pars est data tertia matri,
urn:cts:mid:catullus.62:67	tertia sola tua est: noli pugnare duobus,
urn:cts:mid:catullus.62:68	qui genero suo iura simul cum dote dederunt.
urn:cts:mid:catullus.62:69	Hymen o Hymenaee, Hymen ades o Hymenaee!
urn:cts:mid:catullus.63:1	Super alta vectus Attis celeri rate maria,
urn:cts:mid:catullus.63:2	Phrygium ut nemus citato cupide pede tetigit,
urn:cts:mid:catullus.63:3	adiitque opaca silvis redimita loca deae,
urn:cts:mid:catullus.63:4	stimulatus ibi furenti rabie, vagus animis,
urn:cts:mid:catullus.63:5	de volsit ili acuto sibi pondera silice,
urn:cts:mid:catullus.63:6	itaque ut relicta sensit sibi membra sine viro,
urn:cts:mid:catullus.63:7	etiam recente terrae sola sanguine maculans,
urn:cts:mid:catullus.63:8	niveis citata cepit manibus leve typanum,
urn:cts:mid:catullus.63:9	typanum tuum, Cybebe, tua, mater initia,
urn:cts:mid:catullus.63:10	quatiensque terga tauri teneris cava digitis
urn:cts:mid:catullus.63:11	canere haec suis adorta est tremebunda comitibus.
urn:cts:mid:catullus.63:12	'agite ite ad alta, Gallae, Cybeles nemora simul,
urn:cts:mid:catullus.63:13	simul ite, Dindymenae dominae vaga pecora,
urn:cts:mid:catullus.63:14	aliena quae petentes velut exules loca
urn:cts:mid:catullus.63:15	sectam meam exsecutae duce me mihi comites
urn:cts:mid:catullus.63:16	rapidum salum tulistis truculentaque pelagi
urn:cts:mid:catullus.63:17	et corpus evirastis Veneris nimio odio;
urn:cts:mid:catullus.63:18	hilarate erae citatis erroribus animum.
urn:cts:mid:catullus.63:19	mora tarda mente cedat: simul ite, sequimini
urn:cts:mid:catullus.63:20	Phrygiam ad domum Cybebes, Phrygia ad nemora deae,
urn:cts:mid:catullus.63:21	ubi cymbalum sonat vox, ubi tympana reboant,
urn:cts:mid:catullus.63:22	tibicen ubi canit Phryx curvo grave calamo,
urn:cts:mid:catullus.63:23	ubi capita Maenades ui iaciunt hederigerae,
urn:cts:mid:catullus.63:24	ubi sacra sancta acutis ululatibus agitant,
urn:cts:mid:catullus.63:25	ubi suevit illa divae volitare vaga cohors,
urn:cts:mid:catullus.63:26	quo nos decet citatis celerare tripudiis.'
urn:cts:mid:catullus.63:27	simul haec comitibus Attis cecinit notha mulier,
urn:cts:mid:catullus.63:28	thiasus repente linguis trepidantibus ululat,
urn:cts:mid:catullus.63:29	leve tympanum remugit, cava cymbala recrepant.
urn:cts:mid:catullus.63:30	viridem citus adit Idam properante pede chorus.
urn:cts:mid:catullus.63:31	furibunda simul anhelans vaga vadit animam agens
urn:cts:mid:catullus.63:32	comitata tympano Attis per opaca nemora dux,
urn:cts:mid:catullus.63:33	veluti iuvenca vitans onus indomita iugi;
urn:cts:mid:catullus.63:34	rapidae ducem sequuntur Gallae properipedem.
urn:cts:mid:catullus.63:35	itaque, ut domum Cybebes tetigere lassulae,
urn:cts:mid:catullus.63:36	nimio e labore somnum capiunt sine Cerere.
urn:cts:mid:catullus.63:37	piger his labante languore oculos sopor operit;
urn:cts:mid:catullus.63:38	abit in quiete molli rabidus furor animi.
urn:cts:mid:catullus.63:39	sed ubi oris aurei Sol radiantibus oculis
urn:cts:mid:catullus.63:40	lustravit aethera album, sola dura, mare ferum,
urn:cts:mid:catullus.63:41	pepulitque noctis umbras vegetis sonipedibus,
urn:cts:mid:catullus.63:42	ibi Somnus excitam Attin fugiens citus abiit;
urn:cts:mid:catullus.63:43	trepidante eum recepit dea Pasithea sinu.
urn:cts:mid:catullus.63:44	ita de quiete molli rapida sine rabie
urn:cts:mid:catullus.63:45	simul ipsa pectore Attis sua facta recoluit,
urn:cts:mid:catullus.63:46	liquidaque mente vidit sine quis ubique foret,
urn:cts:mid:catullus.63:47	animo aestuante rusum reditum ad vada tetulit.
urn:cts:mid:catullus.63:48	ibi maria vasta visens lacrimantibus oculis,
urn:cts:mid:catullus.63:49	patriam allocuta maestast ita voce miseriter.
urn:cts:mid:catullus.63:50	'patria o mei creatrix, patria o mea genetrix,
urn:cts:mid:catullus.63:51	ego quam miser relinquens, dominos ut erifugae
urn:cts:mid:catullus.63:52	famuli solent, ad Idae tetuli nemora pedem,
urn:cts:mid:catullus.63:53	ut apud nivem et ferarum gelida stabula forem,
urn:cts:mid:catullus.63:54	et earum omnia adirem furibunda latibula,
urn:cts:mid:catullus.63:55	ubinam aut quibus locis te positam, patria, reor?
urn:cts:mid:catullus.63:56	cupit ipsa pupula ad te sibi derigere aciem,
urn:cts:mid:catullus.63:57	rabie fera carens dum breve tempus animus est.
urn:cts:mid:catullus.63:58	egone a mea remota haec ferar in nemora domo?
urn:cts:mid:catullus.63:59	patria, bonis, amicis, genitoribus abero?
urn:cts:mid:catullus.63:60	abero foro, palaestra, stadio et gyminasiis?
urn:cts:mid:catullus.63:61	miser a miser, querendum est etiam atque etiam, anime.
urn:cts:mid:catullus.63:62	quod enim genus figurast, ego non quod obierim?
urn:cts:mid:catullus.63:63	ego mulier, ego adulescens, ego ephebus, ego puer,
urn:cts:mid:catullus.63:64	ego gymnasi fui flos, ego eram decus olei:
urn:cts:mid:catullus.63:65	mihi ianuae frequentes, mihi limina tepida,
urn:cts:mid:catullus.63:66	mihi floridis corollis redimita domus erat,
urn:cts:mid:catullus.63:67	linquendum ubi esset orto mihi Sole cubiculum.
urn:cts:mid:catullus.63:68	ego nunc deum ministra et Cybeles famula ferar?
urn:cts:mid:catullus.63:69	ego Maenas, ego mei pars, ego vir sterilis ero?
urn:cts:mid:catullus.63:70	ego viridis algida Idae nive amicta loca colam?
urn:cts:mid:catullus.63:71	ego vitam agam sub altis Phrygiae columinibus,
urn:cts:mid:catullus.63:72	ubi cerva silvicultrix, ubi aper nemorivagus?
urn:cts:mid:catullus.63:73	iam iam dolet quod egi, iam iamque paenitet.'
urn:cts:mid:catullus.63:74	roseis ut huic labellis sonitus citus abiit
urn:cts:mid:catullus.63:75	geminas deorum ad aures nova nuntia referens,
urn:cts:mid:catullus.63:76	ibi iuncta iuga resolvens Cybele leonibus
urn:cts:mid:catullus.63:77	laevumque pecoris hostem stimulans ita loquitur.
urn:cts:mid:catullus.63:78	'agedum,' inquit 'age ferox i, fac ut hunc furor
urn:cts:mid:catullus.63:79	fac uti furoris ictu reditum in nemora ferat,
urn:cts:mid:catullus.63:80	mea libere nimis qui fugere imperia cupit.
urn:cts:mid:catullus.63:81	age caede terga cauda, tua verbera patere,
urn:cts:mid:catullus.63:82	fac cuncta mugienti fremitu loca retonent,
urn:cts:mid:catullus.63:83	rutilam ferox torosa cervice quate iubam.'
urn:cts:mid:catullus.63:84	ait haec minax Cybebe religatque iuga manu.
urn:cts:mid:catullus.63:85	ferus ipse sese adhortans rapidum incitat animo,
urn:cts:mid:catullus.63:86	vadit, fremit, refringit virgulta pede vago.
urn:cts:mid:catullus.63:87	at ubi umida albicantis loca litoris adiit,
urn:cts:mid:catullus.63:88	teneramque vidit Attin prope marmora pelagi,
urn:cts:mid:catullus.63:89	facit impetum. illa demens fugit in nemora fera;
urn:cts:mid:catullus.63:90	ibi semper omne vitae spatium famula fuit.
urn:cts:mid:catullus.63:91	dea, magna dea, Cybebe, dea domina Dindymi,
urn:cts:mid:catullus.63:92	procul a mea tuos sit furor omnis, era, domo:
urn:cts:mid:catullus.63:93	alios age incitatos, alios age rabidos.
urn:cts:mid:catullus.64:1	Peliaco quondam prognatae vertice pinus
urn:cts:mid:catullus.64:2	dicuntur liquidas Neptuni nasse per undas
urn:cts:mid:catullus.64:3	Phasidos ad fluctus et fines Aeetaeos,
urn:cts:mid:catullus.64:4	cum lecti iuvenes, Argiuae robora pubis,
urn:cts:mid:catullus.64:5	auratam optantes Colchis avertere pellem
urn:cts:mid:catullus.64:6	ausi sunt vada salsa cita decurrere puppi,
urn:cts:mid:catullus.64:7	caerula verrentes abiegnis aequora palmis.
urn:cts:mid:catullus.64:8	diva quibus retinens in summis urbibus arces
urn:cts:mid:catullus.64:9	ipsa levi fecit volitantem flamine currum,
urn:cts:mid:catullus.64:10	pinea coniungens inflexae texta carinae.
urn:cts:mid:catullus.64:11	illa rudem cursu prima imbuit Amphitriten;
urn:cts:mid:catullus.64:12	quae simul ac rostro ventosum proscidit aequor
urn:cts:mid:catullus.64:13	tortaque remigio spumis incanuit unda,
urn:cts:mid:catullus.64:14	emersere freti candenti e gurgite vultus
urn:cts:mid:catullus.64:15	aequoreae monstrum Nereides admirantes.
urn:cts:mid:catullus.64:16	illa, atque alia, viderunt luce marinas
urn:cts:mid:catullus.64:17	mortales oculis nudato corpore Nymphas
urn:cts:mid:catullus.64:18	nutricum tenus exstantes e gurgite cano.
urn:cts:mid:catullus.64:19	tum Thetidis Peleus incensus fertur amore,
urn:cts:mid:catullus.64:20	tum Thetis humanos non despexit hymenaeos,
urn:cts:mid:catullus.64:21	tum Thetidi pater ipse iugandum Pelea sensit.
urn:cts:mid:catullus.64:22	o nimis optato saeclorum tempore nati
urn:cts:mid:catullus.64:23	heroes, salvete, deum genus! o bona matrum
urn:cts:mid:catullus.64:24	progenies, salvete iter...
urn:cts:mid:catullus.64:25	vos ego saepe, meo vos carmine compellabo.
urn:cts:mid:catullus.64:26	teque adeo eximie taedis felicibus aucte,
urn:cts:mid:catullus.64:27	Thessaliae columen Peleu, cui Iuppiter ipse,
urn:cts:mid:catullus.64:28	ipse suos divum genitor concessit amores;
urn:cts:mid:catullus.64:29	tene Thetis tenuit pulcerrima Nereine?
urn:cts:mid:catullus.64:30	tene suam Tethys concessit ducere neptem,
urn:cts:mid:catullus.64:31	Oceanusque, mari totum qui amplectitur orbem?
urn:cts:mid:catullus.64:32	quae simul optatae finito tempore luces
urn:cts:mid:catullus.64:33	advenere, domum conventu tota frequentat
urn:cts:mid:catullus.64:34	Thessalia, oppletur laetanti regia coetu:
urn:cts:mid:catullus.64:35	dona ferunt prae se, declarant gaudia vultu.
urn:cts:mid:catullus.64:36	deseritur Cieros, linquunt Pthiotica Tempe
urn:cts:mid:catullus.64:37	Crannonisque domos ac moenia Larisaea,
urn:cts:mid:catullus.64:38	Pharsalum coeunt, Pharsalia tecta frequentant.
urn:cts:mid:catullus.64:39	rura colit nemo, mollescunt colla iuvencis,
urn:cts:mid:catullus.64:40	non humilis curvis purgatur vinea rastris,
urn:cts:mid:catullus.64:41	non glebam prono convellit vomere taurus,
urn:cts:mid:catullus.64:42	non falx attenuat frondatorum arboris umbram,
urn:cts:mid:catullus.64:43	squalida desertis rubigo infertur aratris.
urn:cts:mid:catullus.64:44	ipsius at sedes, quacumque opulenta recessit
urn:cts:mid:catullus.64:45	regia, fulgenti splendent auro atque argento.
urn:cts:mid:catullus.64:46	candet ebur soliis, collucent pocula mensae,
urn:cts:mid:catullus.64:47	tota domus gaudet regali splendida gaza.
urn:cts:mid:catullus.64:48	pulvinar vero divae geniale locatur
urn:cts:mid:catullus.64:49	sedibus in mediis, Indo quod dente politum
urn:cts:mid:catullus.64:50	tincta tegit roseo conchyli purpura fuco.
urn:cts:mid:catullus.64:51	haec vestis priscis hominum variata figuris
urn:cts:mid:catullus.64:52	heroum mira virtutes indicat arte.
urn:cts:mid:catullus.64:53	namque fluentisono prospectans litore Diae,
urn:cts:mid:catullus.64:54	Thesea cedentem celeri cum classe tuetur
urn:cts:mid:catullus.64:55	indomitos in corde gerens Ariadna furores,
urn:cts:mid:catullus.64:56	necdum etiam sese quae visit visere credit,
urn:cts:mid:catullus.64:57	utpote fallaci quae tum primum excita somno
urn:cts:mid:catullus.64:58	desertam in sola miseram se cernat harena.
urn:cts:mid:catullus.64:59	immemor at iuvenis fugiens pellit vada remis,
urn:cts:mid:catullus.64:60	irrita ventosae linquens promissa procellae.
urn:cts:mid:catullus.64:61	quem procul ex alga maestis Minois ocellis,
urn:cts:mid:catullus.64:62	saxea ut effigies bacchantis, prospicit, eheu,
urn:cts:mid:catullus.64:63	prospicit et magnis curarum fluctuat undis,
urn:cts:mid:catullus.64:64	non flavo retinens subtilem vertice mitram,
urn:cts:mid:catullus.64:65	non contecta levi velatum pectus amictu,
urn:cts:mid:catullus.64:66	non tereti strophio lactentis vincta papillas,
urn:cts:mid:catullus.64:67	omnia quae toto delapsa e corpore passim
urn:cts:mid:catullus.64:68	ipsius ante pedes fluctus salis alludebant.
urn:cts:mid:catullus.64:69	sed neque tum mitrae neque tum fluitantis amictus
urn:cts:mid:catullus.64:70	illa vicem curans toto ex te pectore, Theseu,
urn:cts:mid:catullus.64:71	toto animo, tota pendebat perdita mente.
urn:cts:mid:catullus.64:72	misera, assiduis quam luctibus externavit
urn:cts:mid:catullus.64:73	spinosas Erycina serens in pectore curas,
urn:cts:mid:catullus.64:74	illa tempestate, ferox quo ex tempore Theseus
urn:cts:mid:catullus.64:75	egressus curvis e litoribus Piraei
urn:cts:mid:catullus.64:76	attigit iniusti regis Gortynia templa.
urn:cts:mid:catullus.64:77	nam perhibent olim crudeli peste coactam
urn:cts:mid:catullus.64:78	Androgeoneae poenas exsolvere caedis
urn:cts:mid:catullus.64:79	electos iuvenes simul et decus innuptarum
urn:cts:mid:catullus.64:80	Cecropiam solitam esse dapem dare Minotauro.
urn:cts:mid:catullus.64:81	quis angusta malis cum moenia vexarentur,
urn:cts:mid:catullus.64:82	ipse suum Theseus pro caris corpus Athenis
urn:cts:mid:catullus.64:83	proicere optavit potius quam talia Cretam
urn:cts:mid:catullus.64:84	funera Cecropiae nec funera portarentur.
urn:cts:mid:catullus.64:85	atque ita nave levi nitens ac lenibus auris
urn:cts:mid:catullus.64:86	magnanimum ad Minoa venit sedesque superbas.
urn:cts:mid:catullus.64:87	hunc simul ac cupido conspexit lumine virgo
urn:cts:mid:catullus.64:88	regia, quam suavis exspirans castus odores
urn:cts:mid:catullus.64:89	lectulus in molli complexu matris alebat,
urn:cts:mid:catullus.64:90	quales Eurotae praecingunt flumina myrtus
urn:cts:mid:catullus.64:91	aurave distinctos educit verna colores,
urn:cts:mid:catullus.64:92	non prius ex illo flagrantia declinavit
urn:cts:mid:catullus.64:93	lumina, quam cuncto concepit corpore flammam
urn:cts:mid:catullus.64:94	funditus atque imis exarsit tota medullis.
urn:cts:mid:catullus.64:95	heu misere exagitans immiti corde furores
urn:cts:mid:catullus.64:96	sancte puer, curis hominum qui gaudia misces,
urn:cts:mid:catullus.64:97	quaeque regis Golgos quaeque Idalium frondosum,
urn:cts:mid:catullus.64:98	qualibus incensam iactastis mente puellam
urn:cts:mid:catullus.64:99	fluctibus, in flavo saepe hospite suspirantem!
urn:cts:mid:catullus.64:100	quantos illa tulit languenti corde timores!
urn:cts:mid:catullus.64:101	quanto saepe magis fulgore expalluit auri,
urn:cts:mid:catullus.64:102	cum saevum cupiens contra contendere monstrum
urn:cts:mid:catullus.64:103	aut mortem appeteret Theseus aut praemia laudis!
urn:cts:mid:catullus.64:104	non ingrata tamen frustra munuscula divis
urn:cts:mid:catullus.64:105	promittens tacito succepit vota labello.
urn:cts:mid:catullus.64:106	nam velut in summo quatientem brachia Tauro
urn:cts:mid:catullus.64:107	quercum aut conigeram sudanti cortice pinum
urn:cts:mid:catullus.64:108	indomitus turbo contorquens flamine robur,
urn:cts:mid:catullus.64:109	eruit (illa procul radicitus exturbata
urn:cts:mid:catullus.64:110	prona cadit, late quaevis cumque obuia frangens,)
urn:cts:mid:catullus.64:111	sic domito saevum prostravit corpore Theseus
urn:cts:mid:catullus.64:112	nequiquam vanis iactantem cornua ventis.
urn:cts:mid:catullus.64:113	inde pedem sospes multa cum laude reflexit
urn:cts:mid:catullus.64:114	errabunda regens tenui vestigia filo,
urn:cts:mid:catullus.64:115	ne labyrintheis e flexibus egredientem
urn:cts:mid:catullus.64:116	tecti frustraretur inobservabilis error.
urn:cts:mid:catullus.64:117	sed quid ego a primo digressus carmine plura
urn:cts:mid:catullus.64:118	commemorem, ut linquens genitoris filia vultum,
urn:cts:mid:catullus.64:119	ut consanguineae complexum, ut denique matris,
urn:cts:mid:catullus.64:120	quae misera in gnata deperdita laeta
urn:cts:mid:catullus.64:121	omnibus his Thesei dulcem praeoptarit amorem:
urn:cts:mid:catullus.64:122	aut ut vecta rati spumosa ad litora Diae
urn:cts:mid:catullus.64:123	aut ut eam devinctam lumina somno
urn:cts:mid:catullus.64:124	liquerit immemori discedens pectore coniunx?
urn:cts:mid:catullus.64:125	saepe illam perhibent ardenti corde furentem
urn:cts:mid:catullus.64:126	clarisonas imo fudisse e pectore voces,
urn:cts:mid:catullus.64:127	ac tum praeruptos tristem conscendere montes,
urn:cts:mid:catullus.64:128	unde aciem pelagi vastos protenderet aestus,
urn:cts:mid:catullus.64:129	tum tremuli salis adversas procurrere in undas
urn:cts:mid:catullus.64:130	mollia nudatae tollentem tegmina surae,
urn:cts:mid:catullus.64:131	atque haec extremis maestam dixisse querellis,
urn:cts:mid:catullus.64:132	frigidulos udo singultus ore cientem:
urn:cts:mid:catullus.64:133	'sicine me patriis avectam, perfide, ab aris
urn:cts:mid:catullus.64:134	perfide, deserto liquisti in litore, Theseu?
urn:cts:mid:catullus.64:135	sicine discedens neglecto numine divum,
urn:cts:mid:catullus.64:136	immemor a! devota domum periuria portas?
urn:cts:mid:catullus.64:137	nullane res potuit crudelis flectere mentis
urn:cts:mid:catullus.64:138	consilium? tibi nulla fuit clementia praesto,
urn:cts:mid:catullus.64:139	immite ut nostri vellet miserescere pectus?
urn:cts:mid:catullus.64:140	at non haec quondam blanda promissa dedisti
urn:cts:mid:catullus.64:141	voce mihi, non haec miserae sperare iubebas,
urn:cts:mid:catullus.64:142	sed conubia laeta, sed optatos hymenaeos,
urn:cts:mid:catullus.64:143	quae cuncta aereii discerpunt irrita venti.
urn:cts:mid:catullus.64:144	nunc iam nulla viro iuranti femina credat,
urn:cts:mid:catullus.64:145	nulla viri speret sermones esse fideles;
urn:cts:mid:catullus.64:146	quis dum aliquid cupiens animus praegestit apisci,
urn:cts:mid:catullus.64:147	nil metuunt iurare, nihil promittere parcunt:
urn:cts:mid:catullus.64:148	sed simul ac cupidae mentis satiata libido est,
urn:cts:mid:catullus.64:149	dicta nihil metuere, nihil periuria curant.
urn:cts:mid:catullus.64:150	certe ego te in medio versantem turbine leti
urn:cts:mid:catullus.64:151	eripui, et potius germanum amittere crevi,
urn:cts:mid:catullus.64:152	quam tibi fallaci supremo in tempore dessem.
urn:cts:mid:catullus.64:153	pro quo dilaceranda feris dabor alitibusque
urn:cts:mid:catullus.64:154	praeda, neque iniacta tumulabor mortua terra.
urn:cts:mid:catullus.64:155	quaenam te genuit sola sub rupe leaena,
urn:cts:mid:catullus.64:156	quod mare conceptum spumantibus exspuit undis,
urn:cts:mid:catullus.64:157	quae Syrtis, quae Scylla rapax, quae vasta Carybdis,
urn:cts:mid:catullus.64:158	talia qui reddis pro dulci praemia vita?
urn:cts:mid:catullus.64:159	si tibi non cordi fuerant conubia nostra,
urn:cts:mid:catullus.64:160	saeva quod horrebas prisci praecepta parentis,
urn:cts:mid:catullus.64:161	attamen in vestras potuisti ducere sedes,
urn:cts:mid:catullus.64:162	quae tibi iucundo famularer serva labore,
urn:cts:mid:catullus.64:163	candida permulcens liquidis vestigia lymphis,
urn:cts:mid:catullus.64:164	purpureave tuum consternens veste cubile.
urn:cts:mid:catullus.64:165	sed quid ego ignaris nequiquam conquerar auris,
urn:cts:mid:catullus.64:166	externata malo, quae nullis sensibus auctae
urn:cts:mid:catullus.64:167	nec missas audire queunt nec reddere voces?
urn:cts:mid:catullus.64:168	ille autem prope iam mediis versatur in undis,
urn:cts:mid:catullus.64:169	nec quisquam apparet vacua mortalis in alga.
urn:cts:mid:catullus.64:170	sic nimis insultans extremo tempore saeva
urn:cts:mid:catullus.64:171	fors etiam nostris invidit questibus auris.
urn:cts:mid:catullus.64:172	Iuppiter omnipotens, utinam ne tempore primo
urn:cts:mid:catullus.64:173	Gnosia Cecropiae tetigissent litora puppes,
urn:cts:mid:catullus.64:174	indomito nec dira ferens stipendia tauro
urn:cts:mid:catullus.64:175	perfidus in Cretam religasset navita funem,
urn:cts:mid:catullus.64:176	nec malus hic celans dulci crudelia forma
urn:cts:mid:catullus.64:177	consilia in nostris requiesset sedibus hospes!
urn:cts:mid:catullus.64:178	nam quo me referam? quali spe perdita nitor?
urn:cts:mid:catullus.64:179	Idaeosne petam montes? at gurgite lato
urn:cts:mid:catullus.64:180	discernens ponti truculentum dividit aequor.
urn:cts:mid:catullus.64:181	an patris auxilium sperem? quemne ipsa reliqui
urn:cts:mid:catullus.64:182	respersum iuvenem fraterna caede secuta?
urn:cts:mid:catullus.64:183	coniugis an fido consoler memet amore?
urn:cts:mid:catullus.64:184	quine fugit lentos incuruans gurgite remos?
urn:cts:mid:catullus.64:185	praeterea nullo colitur sola insula tecto,
urn:cts:mid:catullus.64:186	nec patet egressus pelagi cingentibus undis.
urn:cts:mid:catullus.64:187	nulla fugae ratio, nulla spes: omnia muta,
urn:cts:mid:catullus.64:188	omnia sunt deserta, ostentant omnia letum.
urn:cts:mid:catullus.64:189	non tamen ante mihi languescent lumina morte,
urn:cts:mid:catullus.64:190	nec prius a fesso secedent corpore sensus,
urn:cts:mid:catullus.64:191	quam iustam a divis exposcam prodita multam
urn:cts:mid:catullus.64:192	caelestumque fidem postrema comprecer hora.
urn:cts:mid:catullus.64:193	quare facta virum multantes vindice poena
urn:cts:mid:catullus.64:194	Eumenides, quibus anguino redimita capillo
urn:cts:mid:catullus.64:195	frons exspirantis praeportat pectoris iras,
urn:cts:mid:catullus.64:196	huc huc adventate, meas audite querellas,
urn:cts:mid:catullus.64:197	quas ego, vae misera, extremis proferre medullis
urn:cts:mid:catullus.64:198	cogor inops, ardens, amenti caeca furore.
urn:cts:mid:catullus.64:199	quae quoniam verae nascuntur pectore ab imo,
urn:cts:mid:catullus.64:200	vos nolite pati nostrum vanescere luctum,
urn:cts:mid:catullus.64:201	sed quali solam Theseus me mente reliquit,
urn:cts:mid:catullus.64:202	tali mente, deae, funestet seque suosque.'
urn:cts:mid:catullus.64:203	has postquam maesto profudit pectore voces,
urn:cts:mid:catullus.64:204	supplicium saevis ecens anxia factis,
urn:cts:mid:catullus.64:205	annuit invicto caelestum numine rector;
urn:cts:mid:catullus.64:206	quo motu tellus atque horrida contremuerunt
urn:cts:mid:catullus.64:207	aequora concussitque micantia sidera mundus.
urn:cts:mid:catullus.64:208	ipse autem caeca mentem caligine Theseus
urn:cts:mid:catullus.64:209	consitus oblito dimisit pectore cuncta,
urn:cts:mid:catullus.64:210	quae mandata prius constanti mente tenebat,
urn:cts:mid:catullus.64:211	dulcia nec maesto sustollens signa parenti
urn:cts:mid:catullus.64:212	sospitem Erechtheum se ostendit visere portum.
urn:cts:mid:catullus.64:213	namque ferunt olim, classi cum moenia divae
urn:cts:mid:catullus.64:214	linquentem gnatum ventis concrederet Aegeus,
urn:cts:mid:catullus.64:215	talia complexum iuveni mandata dedisse:
urn:cts:mid:catullus.64:216	'gnate mihi longa iucundior unice vita,
urn:cts:mid:catullus.64:217	gnate, ego quem in dubios cogor dimittere casus,
urn:cts:mid:catullus.64:218	reddite in extrema nuper mihi fine senectae,
urn:cts:mid:catullus.64:219	quandoquidem fortuna mea ac tua feruida virtus
urn:cts:mid:catullus.64:220	eripit invito mihi te, cui languida nondum
urn:cts:mid:catullus.64:221	lumina sunt gnati cara saturata figura,
urn:cts:mid:catullus.64:222	non ego te gaudens laetanti pectore mittam,
urn:cts:mid:catullus.64:223	nec te ferre sinam fortunae signa secundae,
urn:cts:mid:catullus.64:224	sed primum multas expromam mente querellas,
urn:cts:mid:catullus.64:225	canitiem terra atque infuso puluere foedans,
urn:cts:mid:catullus.64:226	inde infecta vago suspendam lintea malo,
urn:cts:mid:catullus.64:227	nostros ut luctus nostraeque incendia mentis
urn:cts:mid:catullus.64:228	carbasus obscurata dicet ferrugine Hibera.
urn:cts:mid:catullus.64:229	quod tibi si sancti concesserit incola Itoni,
urn:cts:mid:catullus.64:230	quae nostrum genus ac sedes defendere Erecthei
urn:cts:mid:catullus.64:231	annuit, ut tauri respergas sanguine dextram,
urn:cts:mid:catullus.64:232	tum vero facito ut memori tibi condita corde
urn:cts:mid:catullus.64:233	haec vigeant mandata, nec ulla oblitteret aetas;
urn:cts:mid:catullus.64:234	ut simul ac nostros invisent lumina collis,
urn:cts:mid:catullus.64:235	funestam antennae deponant undique vestem,
urn:cts:mid:catullus.64:236	candidaque intorti sustollant vela rudentes,
urn:cts:mid:catullus.64:237	quam primum cernens ut laeta gaudia mente
urn:cts:mid:catullus.64:238	agnoscam, cum te reducem aetas prospera sistet.'
urn:cts:mid:catullus.64:239	haec mandata prius constanti mente tenentem
urn:cts:mid:catullus.64:240	Thesea ceu pulsae ventorum flamine nubes
urn:cts:mid:catullus.64:241	aereum nivei montis liquere cacumen.
urn:cts:mid:catullus.64:242	at pater, ut summa prospectum ex arce petebat,
urn:cts:mid:catullus.64:243	anxia in assiduos absumens lumina fletus,
urn:cts:mid:catullus.64:244	cum primum infecti conspexit lintea veli,
urn:cts:mid:catullus.64:245	praecipitem sese scopulorum e vertice iecit,
urn:cts:mid:catullus.64:246	amissum credens immiti Thesea fato.
urn:cts:mid:catullus.64:247	sic funesta domus ingressus tecta paterna
urn:cts:mid:catullus.64:248	morte ferox Theseus, qualem Minoidi luctum
urn:cts:mid:catullus.64:249	obtulerat mente immemori, talem ipse recepit.
urn:cts:mid:catullus.64:250	quae tum prospectans cedentem maesta carinam
urn:cts:mid:catullus.64:251	multiplices animo voluebat saucia curas.
urn:cts:mid:catullus.64:252	at parte ex alia florens volitabat Iacchus
urn:cts:mid:catullus.64:253	cum thiaso Satyrorum et Nysigenis Silenis,
urn:cts:mid:catullus.64:254	te quaerens, Ariadna, tuoque incensus amore.
urn:cts:mid:catullus.64:255	* * * * * * * * 
urn:cts:mid:catullus.64:256	quae tum alacres passim lymphata mente furebant
urn:cts:mid:catullus.64:257	euhoe bacchantes, euhoe capita inflectentes.
urn:cts:mid:catullus.64:258	harum pars tecta quatiebant cuspide thyrsos,
urn:cts:mid:catullus.64:259	pars e divolso iactabant membra iuvenco,
urn:cts:mid:catullus.64:260	pars sese tortis serpentibus incingebant,
urn:cts:mid:catullus.64:261	pars obscura cavis celebrabant orgia cistis,
urn:cts:mid:catullus.64:262	orgia quae frustra cupiunt audire profani;
urn:cts:mid:catullus.64:263	plangebant aliae proceris tympana palmis,
urn:cts:mid:catullus.64:264	aut tereti tenuis tinnitus aere ciebant;
urn:cts:mid:catullus.64:265	multis raucisonos efflabant cornua bombos
urn:cts:mid:catullus.64:266	barbaraque horribili stridebat tibia cantu.
urn:cts:mid:catullus.64:267	talibus amplifice vestis decorata figuris
urn:cts:mid:catullus.64:268	pulvinar complexa suo velabat amictu.
urn:cts:mid:catullus.64:269	quae postquam cupide spectando Thessala pubes
urn:cts:mid:catullus.64:270	expleta est, sanctis coepit decedere divis.
urn:cts:mid:catullus.64:271	hic, qualis flatu placidum mare matutino
urn:cts:mid:catullus.64:272	horrificans Zephyrus procliuas incitat undas,
urn:cts:mid:catullus.64:273	Aurora exoriente vagi sub limina Solis,
urn:cts:mid:catullus.64:274	quae tarde primum clementi flamine pulsae
urn:cts:mid:catullus.64:275	procedunt leviterque sonant plangore cachinni,
urn:cts:mid:catullus.64:276	post vento crescente magis magis increbescunt,
urn:cts:mid:catullus.64:277	purpureaque procul nantes ab luce refulgent:
urn:cts:mid:catullus.64:278	sic tum vestibuli linquentes regia tecta
urn:cts:mid:catullus.64:279	ad se quisque vago passim pede discedebant.
urn:cts:mid:catullus.64:280	quorum post abitum princeps e vertice Pelei
urn:cts:mid:catullus.64:281	advenit Chiron portans siluestria dona:
urn:cts:mid:catullus.64:282	nam quoscumque ferunt campi, quos Thessala magnis
urn:cts:mid:catullus.64:283	montibus ora creat, quos propter fluminis undas
urn:cts:mid:catullus.64:284	aura parit flores tepidi fecunda Favoni,
urn:cts:mid:catullus.64:285	hos indistinctis plexos tulit ipse corollis,
urn:cts:mid:catullus.64:286	quo permulsa domus iucundo risit odore.
urn:cts:mid:catullus.64:287	confestim Penios adest, viridantia Tempe,
urn:cts:mid:catullus.64:288	Tempe, quae silvae cingunt super impendentes,
urn:cts:mid:catullus.64:289	Minosim linquens doris celebranda choreis,
urn:cts:mid:catullus.64:290	non vacuos: namque ille tulit radicitus altas
urn:cts:mid:catullus.64:291	fagos ac recto proceras stipite laurus,
urn:cts:mid:catullus.64:292	non sine nutanti platano lentaque sorore
urn:cts:mid:catullus.64:293	flammati Phaethontis et aerea cupressu.
urn:cts:mid:catullus.64:294	haec circum sedes late contexta locavit,
urn:cts:mid:catullus.64:295	vestibulum ut molli velatum fronde vireret.
urn:cts:mid:catullus.64:296	post hunc consequitur sollerti corde Prometheus,
urn:cts:mid:catullus.64:297	extenuata gerens veteris vestigia poenae,
urn:cts:mid:catullus.64:298	quam quondam silici restrictus membra catena
urn:cts:mid:catullus.64:299	persolvit pendens e verticibus praeruptis.
urn:cts:mid:catullus.64:300	inde pater divum sancta cum coniuge natisque
urn:cts:mid:catullus.64:301	advenit caelo, te solum, Phoebe, relinquens
urn:cts:mid:catullus.64:302	unigenamque simul cultricem montibus Idri:
urn:cts:mid:catullus.64:303	Pelea nam tecum pariter soror aspernata est,
urn:cts:mid:catullus.64:304	nec Thetidis taedas voluit celebrare iugales.
urn:cts:mid:catullus.64:305	qui postquam niveis flexerunt sedibus artus
urn:cts:mid:catullus.64:306	large multiplici constructae sunt dape mensae,
urn:cts:mid:catullus.64:307	cum interea infirmo quatientes corpora motu
urn:cts:mid:catullus.64:308	veridicos Parcae coeperunt edere cantus.
urn:cts:mid:catullus.64:309	his corpus tremulum complectens undique vestis
urn:cts:mid:catullus.64:310	candida purpurea talos incinxerat ora,
urn:cts:mid:catullus.64:311	at roseae niveo residebant vertice vittae,
urn:cts:mid:catullus.64:312	aeternumque manus carpebant rite laborem.
urn:cts:mid:catullus.64:313	laeva colum molli lana retinebat amictum,
urn:cts:mid:catullus.64:314	dextera tum leviter deducens fila supinis
urn:cts:mid:catullus.64:315	formabat digitis, tum prono in pollice torquens
urn:cts:mid:catullus.64:316	libratum tereti versabat turbine fusum,
urn:cts:mid:catullus.64:317	atque ita decerpens aequabat semper opus dens,
urn:cts:mid:catullus.64:318	laneaque aridulis haerebant morsa labellis,
urn:cts:mid:catullus.64:319	quae prius in levi fuerant exstantia filo:
urn:cts:mid:catullus.64:320	ante pedes autem candentis mollia lanae
urn:cts:mid:catullus.64:321	vellera virgati custodibant calathisci.
urn:cts:mid:catullus.64:322	haec tum clarisona pellentes vellera voce
urn:cts:mid:catullus.64:323	talia divino fuderunt carmine fata,
urn:cts:mid:catullus.64:324	carmine, perfidiae quod post nulla arguet aetas.
urn:cts:mid:catullus.64:325	o decus eximium magnis virtutibus augens,
urn:cts:mid:catullus.64:326	Emathiae tutamen, Opis carissime nato,
urn:cts:mid:catullus.64:327	accipe, quod laeta tibi pandunt luce sorores,
urn:cts:mid:catullus.64:328	veridicum oraclum: sed vos, quae fata sequuntur,
urn:cts:mid:catullus.64:329	currite ducentes subtegmina, currite, fusi.
urn:cts:mid:catullus.64:330	adveniet tibi iam portans optata maritis
urn:cts:mid:catullus.64:331	Hesperus, adveniet fausto cum sidere coniunx,
urn:cts:mid:catullus.64:332	quae tibi flexanimo mentem perfundat amore,
urn:cts:mid:catullus.64:333	languidulosque paret tecum coniungere somnos,
urn:cts:mid:catullus.64:334	levia substernens robusto bracchia collo.
urn:cts:mid:catullus.64:335	currite ducentes subtegmina, currite, fusi.
urn:cts:mid:catullus.64:336	nulla domus tales umquam contexit amores,
urn:cts:mid:catullus.64:337	nullus amor tali coniunxit foedere amantes,
urn:cts:mid:catullus.64:338	qualis adest Thetidi, qualis concordia Peleo.
urn:cts:mid:catullus.64:339	currite ducentes subtegmina, currite, fusi.
urn:cts:mid:catullus.64:340	nascetur vobis expers terroris Achilles,
urn:cts:mid:catullus.64:341	hostibus haud tergo, sed forti pectore notus,
urn:cts:mid:catullus.64:342	qui persaepe vago victor certamine cursus
urn:cts:mid:catullus.64:343	flammea praevertet celeris vestigia cervae.
urn:cts:mid:catullus.64:344	currite ducentes subtegmina, currite, fusi.
urn:cts:mid:catullus.64:345	non illi quisquam bello se conferet heros,
urn:cts:mid:catullus.64:346	cum Phrygii Teucro manabunt sanguine
urn:cts:mid:catullus.64:347	Troicaque obsidens longinquo moenia bello,
urn:cts:mid:catullus.64:348	periuri Pelopis vastabit tertius heres.
urn:cts:mid:catullus.64:349	currite ducentes subtegmina, currite, fusi.
urn:cts:mid:catullus.64:350	illius egregias virtutes claraque facta
urn:cts:mid:catullus.64:351	saepe fatebuntur gnatorum in funere matres,
urn:cts:mid:catullus.64:352	cum incultum cano solvent a vertice crinem,
urn:cts:mid:catullus.64:353	putridaque infirmis variabunt pectora palmis.
urn:cts:mid:catullus.64:354	currite ducentes subtegmina, currite, fusi.
urn:cts:mid:catullus.64:355	namque velut densas praecerpens messor aristas
urn:cts:mid:catullus.64:356	sole sub ardenti flaventia demetit arua,
urn:cts:mid:catullus.64:357	Troiugenum infesto prosternet corpora ferro.
urn:cts:mid:catullus.64:358	currite ducentes subtegmina, currite, fusi.
urn:cts:mid:catullus.64:359	testis erit magnis virtutibus unda Scamandri,
urn:cts:mid:catullus.64:360	quae passim rapido diffunditur Hellesponto,
urn:cts:mid:catullus.64:361	cuius iter caesis angustans corporum acervis
urn:cts:mid:catullus.64:362	alta tepefaciet permixta flumina caede.
urn:cts:mid:catullus.64:363	currite ducentes subtegmina, currite, fusi.
urn:cts:mid:catullus.64:364	denique testis erit morti quoque reddita praeda,
urn:cts:mid:catullus.64:365	cum teres excelso coaceruatum aggere bustum
urn:cts:mid:catullus.64:366	excipiet niveos perculsae virginis artus.
urn:cts:mid:catullus.64:367	currite ducentes subtegmina, currite, fusi.
urn:cts:mid:catullus.64:368	nam simul ac fessis dederit fors copiam Achivis
urn:cts:mid:catullus.64:369	urbis Dardaniae Neptunia solvere vincla,
urn:cts:mid:catullus.64:370	alta Polyxenia madefient caede sepulcra;
urn:cts:mid:catullus.64:371	quae, velut ancipiti succumbens victima ferro,
urn:cts:mid:catullus.64:372	proiciet truncum summisso poplite corpus.
urn:cts:mid:catullus.64:373	currite ducentes subtegmina, currite, fusi.
urn:cts:mid:catullus.64:374	quare agite optatos animi coniungite amores.
urn:cts:mid:catullus.64:375	accipiat coniunx felici foedere divam,
urn:cts:mid:catullus.64:376	dedatur cupido iam dudum nupta marito.
urn:cts:mid:catullus.64:377	currite ducentes subtegmina, currite, fusi.
urn:cts:mid:catullus.64:378	non illam nutrix orienti luce revisens
urn:cts:mid:catullus.64:379	hesterno collum poterit circumdare filo,
urn:cts:mid:catullus.64:380	anxia nec mater discordis maesta puellae
urn:cts:mid:catullus.64:381	secubitu caros mittet sperare nepotes.
urn:cts:mid:catullus.64:382	currite ducentes subtegmina, currite, fusi.
urn:cts:mid:catullus.64:383	talia praefantes quondam felicia Pelei
urn:cts:mid:catullus.64:384	carmina divino cecinerunt pectore Parcae.
urn:cts:mid:catullus.64:385	praesentes namque ante domos invisere castas
urn:cts:mid:catullus.64:386	heroum, et sese mortali ostendere coetu,
urn:cts:mid:catullus.64:387	caelicolae nondum spreta pietate solebant.
urn:cts:mid:catullus.64:388	saepe pater divum templo in fulgente revisens,
urn:cts:mid:catullus.64:389	annua cum festis venissent sacra diebus,
urn:cts:mid:catullus.64:390	conspexit terra centum procumbere tauros.
urn:cts:mid:catullus.64:391	saepe vagus Liber Parnasi vertice summo
urn:cts:mid:catullus.64:392	Thyiadas effusis euantis crinibus egit,
urn:cts:mid:catullus.64:393	cum Delphi tota certatim ex urbe ruentes
urn:cts:mid:catullus.64:394	acciperent laeti divum fumantibus aris.
urn:cts:mid:catullus.64:395	saepe in letifero belli certamine Mavors
urn:cts:mid:catullus.64:396	aut rapidi Tritonis era aut Amarunsia virgo
urn:cts:mid:catullus.64:397	armatas hominum est praesens hortata catervas.
urn:cts:mid:catullus.64:398	sed postquam tellus scelere est imbuta nefando
urn:cts:mid:catullus.64:399	iustitiamque omnes cupida de mente fugarunt,
urn:cts:mid:catullus.64:400	perfudere manus fraterno sanguine fratres,
urn:cts:mid:catullus.64:401	destitit extinctos gnatus lugere parentes,
urn:cts:mid:catullus.64:402	optavit genitor primaevi funera nati,
urn:cts:mid:catullus.64:403	liber ut innuptae poteretur flore novercae,
urn:cts:mid:catullus.64:404	ignaro mater substernens se impia nato
urn:cts:mid:catullus.64:405	impia non verita est divos scelerare penates.
urn:cts:mid:catullus.64:406	omnia fanda nefanda malo permixta furore
urn:cts:mid:catullus.64:407	iustificam nobis mentem avertere deorum.
urn:cts:mid:catullus.64:408	quare nec talis dignantur visere coetus,
urn:cts:mid:catullus.64:409	nec se contingi patiuntur lumine claro.
urn:cts:mid:catullus.65:1	Etsi me assiduo confectum cura dolore
urn:cts:mid:catullus.65:2	sevocat a doctis, Ortale, virginibus,
urn:cts:mid:catullus.65:3	nec potis est dulcis Musarum expromere fetus
urn:cts:mid:catullus.65:4	mens animi, tantis fluctuat ipsa malis—
urn:cts:mid:catullus.65:5	namque mei nuper Lethaeo in gurgite fratris
urn:cts:mid:catullus.65:6	pallidulum manans alluit unda pedem,
urn:cts:mid:catullus.65:7	Troia Rhoeteo quem subter litore tellus
urn:cts:mid:catullus.65:8	ereptum nostris obterit ex oculis.
urn:cts:mid:catullus.65:9	* * * * * * * * 
urn:cts:mid:catullus.65:10	numquam ego te, vita frater amabilior,
urn:cts:mid:catullus.65:11	aspiciam posthac? at certe semper amabo,
urn:cts:mid:catullus.65:12	semper maesta tua carmina morte canam,
urn:cts:mid:catullus.65:13	qualia sub densis ramorum concinit umbris
urn:cts:mid:catullus.65:14	Daulias, absumpti fata gemens Ityli—
urn:cts:mid:catullus.65:15	sed tamen in tantis maeroribus, Ortale, mitto
urn:cts:mid:catullus.65:16	haec expressa tibi carmina Battiadae,
urn:cts:mid:catullus.65:17	ne tua dicta vagis nequiquam credita ventis
urn:cts:mid:catullus.65:18	effluxisse meo forte putes animo,
urn:cts:mid:catullus.65:19	ut missum sponsi furtivo munere malum
urn:cts:mid:catullus.65:20	procurrit casto virginis e gremio,
urn:cts:mid:catullus.65:21	quod miserae oblitae molli sub veste locatum,
urn:cts:mid:catullus.65:22	dum adventu matris prosilit, excutitur,
urn:cts:mid:catullus.65:23	atque illud prono praeceps agitur decursu,
urn:cts:mid:catullus.65:24	huic manat tristi conscius ore rubor.
urn:cts:mid:catullus.66:1	Omnia qui magni dispexit lumina mundi,
urn:cts:mid:catullus.66:2	qui stellarum ortus comperit atque obitus,
urn:cts:mid:catullus.66:3	flammeus ut rapidi solis nitor obscuretur,
urn:cts:mid:catullus.66:4	ut cedant certis sidera temporibus,
urn:cts:mid:catullus.66:5	ut Triviam furtim sub Latmia saxa relegans
urn:cts:mid:catullus.66:6	dulcis amor gyro devocet aereo:
urn:cts:mid:catullus.66:7	idem me ille Conon caelesti in limine vidit
urn:cts:mid:catullus.66:8	e Beroniceo vertice caesariem
urn:cts:mid:catullus.66:9	fulgentem clare, quam multis illa dearum
urn:cts:mid:catullus.66:10	levia protendens brachia pollicita est,
urn:cts:mid:catullus.66:11	qua rex tempestate novo auctus hymenaeo
urn:cts:mid:catullus.66:12	vastatum finis iuerat Assyrios,
urn:cts:mid:catullus.66:13	dulcia nocturnae portans vestigia rixae,
urn:cts:mid:catullus.66:14	quam de virgineis gesserat exuviis.
urn:cts:mid:catullus.66:15	estne novis nuptis odio Venus? anne parentum
urn:cts:mid:catullus.66:16	frustrantur falsis gaudia lacrimulis,
urn:cts:mid:catullus.66:17	ubertim thalami quas intra limina fundunt?
urn:cts:mid:catullus.66:18	non, ita me divi, vera gemunt, iuerint.
urn:cts:mid:catullus.66:19	id mea me multis docuit regina querellis
urn:cts:mid:catullus.66:20	invisente novo proelia torva viro.
urn:cts:mid:catullus.66:21	et tu non orbum luxti deserta cubile,
urn:cts:mid:catullus.66:22	sed fratris cari flebile discidium?
urn:cts:mid:catullus.66:23	quam penitus maestas exedit cura medullas!
urn:cts:mid:catullus.66:24	ut tibi tunc toto pectore sollicitae
urn:cts:mid:catullus.66:25	sensibus ereptis mens excidit! at ego certe
urn:cts:mid:catullus.66:26	cognoram a parva virgine magnanimam.
urn:cts:mid:catullus.66:27	anne bonum oblita es facinus, quo regium adepta es
urn:cts:mid:catullus.66:28	coniugium, quod non fortior ausit alis?
urn:cts:mid:catullus.66:29	sed tum maesta virum mittens quae verba locuta est!
urn:cts:mid:catullus.66:30	Iuppiter, ut tristi lumina saepe manu!
urn:cts:mid:catullus.66:31	quis te mutavit tantus deus? an quod amantes
urn:cts:mid:catullus.66:32	non longe a caro corpore abesse volunt?
urn:cts:mid:catullus.66:33	atque ibi me cunctis pro dulci coniuge divis
urn:cts:mid:catullus.66:34	non sine taurino sanguine pollicita es,
urn:cts:mid:catullus.66:35	si reditum tetulisset. is haut in tempore longo
urn:cts:mid:catullus.66:36	captam Asiam Aegypti finibus addiderat.
urn:cts:mid:catullus.66:37	quis ego pro factis caelesti reddita coetu
urn:cts:mid:catullus.66:38	pristina vota novo munere dissolvo.
urn:cts:mid:catullus.66:39	invita, o regina, tuo de vertice cessi,
urn:cts:mid:catullus.66:40	invita: adiuro teque tuumque caput,
urn:cts:mid:catullus.66:41	digna ferat quod si quis inaniter adiurarit:
urn:cts:mid:catullus.66:42	sed qui se ferro postulet esse parem?
urn:cts:mid:catullus.66:43	ille quoque eversus mons est, quem maximum in oris
urn:cts:mid:catullus.66:44	progenies Thiae clara supervehitur,
urn:cts:mid:catullus.66:45	cum Medi peperere novum mare, cumque iuventus
urn:cts:mid:catullus.66:46	per medium classi barbara navit Athon.
urn:cts:mid:catullus.66:47	quid facient crines, cum ferro talia cedant?
urn:cts:mid:catullus.66:48	Iuppiter, ut Chalybon omne genus pereat,
urn:cts:mid:catullus.66:49	et qui principio sub terra quaerere venas
urn:cts:mid:catullus.66:50	institit ac ferri stringere duritiem!
urn:cts:mid:catullus.66:51	abiunctae paulo ante comae mea fata sorores
urn:cts:mid:catullus.66:52	lugebant, cum se Memnonis Aethiopis
urn:cts:mid:catullus.66:53	unigena impellens nutantibus aera pennis
urn:cts:mid:catullus.66:54	obtulit Arsinoes Locridis ales equos,
urn:cts:mid:catullus.66:55	isque per aetherias me tollens avolat umbras
urn:cts:mid:catullus.66:56	et Veneris casto collocat in gremio.
urn:cts:mid:catullus.66:57	ipsa suum Zephyritis eo famulum legarat
urn:cts:mid:catullus.66:58	Graiia Canopitis incola litoribus.
urn:cts:mid:catullus.66:59	hi dii ven ibi vario ne solum in lumine caeli
urn:cts:mid:catullus.66:60	ex Ariadnaeis aurea temporibus
urn:cts:mid:catullus.66:61	fixa corona foret, sed nos quoque fulgeremus
urn:cts:mid:catullus.66:62	deuotae flavi verticis exuviae,
urn:cts:mid:catullus.66:63	vuidulam a fluctu cedentem ad templa deum me
urn:cts:mid:catullus.66:64	sidus in antiquis diva novum posuit.
urn:cts:mid:catullus.66:65	Virginis et saevi contingens namque Leonis
urn:cts:mid:catullus.66:66	lumina, Callisto iuncta Lycaoniae,
urn:cts:mid:catullus.66:67	vertor in occasum, tardum dux ante Booten,
urn:cts:mid:catullus.66:68	qui vix sero alto mergitur Oceano.
urn:cts:mid:catullus.66:69	sed quamquam me nocte premunt vestigia divum,
urn:cts:mid:catullus.66:70	lux autem canae Tethyi restituit
urn:cts:mid:catullus.66:71	(pace tua fari hic liceat, Ramnusia virgo,
urn:cts:mid:catullus.66:72	namque ego non ullo vera timore tegam,
urn:cts:mid:catullus.66:73	nec si me infestis discerpent sidera dictis,
urn:cts:mid:catullus.66:74	condita quin veri pectoris evoluam),
urn:cts:mid:catullus.66:75	non his tam laetor rebus, quam me afore semper,
urn:cts:mid:catullus.66:76	afore me a dominae vertice discrucior,
urn:cts:mid:catullus.66:77	quicum ego, dum virgo quondam fuit omnibus expers
urn:cts:mid:catullus.66:78	unguentis, una milia multa bibi.
urn:cts:mid:catullus.66:79	nunc vos, optato quas iunxit lumine taeda,
urn:cts:mid:catullus.66:80	non prius unanimis corpora coniugibus
urn:cts:mid:catullus.66:81	tradite nudantes reiecta veste papillas,
urn:cts:mid:catullus.66:82	quam iucunda mihi munera libet onyx,
urn:cts:mid:catullus.66:83	vester onyx, casto colitis quae iura cubili.
urn:cts:mid:catullus.66:84	sed quae se impuro dedit adulterio,
urn:cts:mid:catullus.66:85	illius a mala dona levis bibat irrita pulvis:
urn:cts:mid:catullus.66:86	namque ego ab indignis praemia nulla peto.
urn:cts:mid:catullus.66:87	sed magis, o nuptae, semper concordia vestras,
urn:cts:mid:catullus.66:88	semper amor sedes incolat assiduus.
urn:cts:mid:catullus.66:89	tu vero, regina, tuens cum sidera divam
urn:cts:mid:catullus.66:90	placabis festis luminibus Venerem,
urn:cts:mid:catullus.66:91	unguinis expertem non siris esse tuam me,
urn:cts:mid:catullus.66:92	sed potius largis affice muneribus.
urn:cts:mid:catullus.66:93	sidera corruerint utinam! coma regia fiam,
urn:cts:mid:catullus.66:94	proximus Hydrochoi fulgeret Oarion!
urn:cts:mid:catullus.67:1	O dulci iucunda virgo, iucunda parenti,
urn:cts:mid:catullus.67:2	salve, teque bona Iuppiter auctet ope,
urn:cts:mid:catullus.67:3	ianua, quam Balbo dicunt servisse benigne
urn:cts:mid:catullus.67:4	olim, cum sedes ipse senex tenuit,
urn:cts:mid:catullus.67:5	quamque ferunt rursus gnato servisse maligne,
urn:cts:mid:catullus.67:6	postquam es porrecto facta marita sene.
urn:cts:mid:catullus.67:7	dic agedum nobis, quare mutata feraris
urn:cts:mid:catullus.67:8	in dominum veterem deseruisse fidem.
urn:cts:mid:catullus.67:9	'Non (ita Caecilio placeam, cui tradita nunc sum)
urn:cts:mid:catullus.67:10	culpa mea est, quamquam dicitur esse mea,
urn:cts:mid:catullus.67:11	nec peccatum a me quisquam pote dicere quicquam:
urn:cts:mid:catullus.67:12	verum istius populi ianua qui te facit,
urn:cts:mid:catullus.67:13	qui quacumque aliquid reperitur non bene factum
urn:cts:mid:catullus.67:14	ad me omnes clamant: ianua, culpa tua est.'
urn:cts:mid:catullus.67:15	Non istuc satis est uno te dicere verbo.
urn:cts:mid:catullus.67:16	sed facere ut quivis sentiat et videat.
urn:cts:mid:catullus.67:17	'Qui possum? nemo quaerit nec scire laborat?'
urn:cts:mid:catullus.67:18	Nos volumus: nobis dicere ne dubita.
urn:cts:mid:catullus.67:19	'Primum igitur, virgo quod fertur tradita nobis,
urn:cts:mid:catullus.67:20	falsum est. non illam vir prior attigerit,
urn:cts:mid:catullus.67:21	languidior tenera cui pendens sicula beta.
urn:cts:mid:catullus.67:22	numquam se mediam sustulit ad tunicam;
urn:cts:mid:catullus.67:23	sed pater illius gnati violasse cubile
urn:cts:mid:catullus.67:24	dicitur et miseram conscelerasse domum,
urn:cts:mid:catullus.67:25	sive quod impia mens caeco flagrabat amore,
urn:cts:mid:catullus.67:26	seu quod iners sterili semine natus erat,
urn:cts:mid:catullus.67:27	ut quaerendum unde foret nervosius illud,
urn:cts:mid:catullus.67:28	quod posset zonam solvere virgineam.'
urn:cts:mid:catullus.67:29	Egregium narras mira pietate parentem.
urn:cts:mid:catullus.67:30	qui ipse sui gnati minxerit in gremium.
urn:cts:mid:catullus.67:31	Atqui non solum hoc dicit se cognitum habere
urn:cts:mid:catullus.67:32	Brixia Cycneae supposita speculae,
urn:cts:mid:catullus.67:33	flavus quam molli praecurrit flumine Mella,
urn:cts:mid:catullus.67:34	Brixia Veronae mater amata meae,
urn:cts:mid:catullus.67:35	sed de Postumio et Corneli narrat amore,
urn:cts:mid:catullus.67:36	cum quibus illa malum fecit adulterium.
urn:cts:mid:catullus.67:37	dixerit hic aliquis: quid? tu istaec, ianua, nosti,
urn:cts:mid:catullus.67:38	cui numquam domini limine abesse licet,
urn:cts:mid:catullus.67:39	nec populum auscultare, sed hic suffixa tigillo
urn:cts:mid:catullus.67:40	tantum operire soles aut aperire domum?
urn:cts:mid:catullus.67:41	saepe illam audivi furtiva voce loquentem
urn:cts:mid:catullus.67:42	solam cum ancillis haec sua flagitia,
urn:cts:mid:catullus.67:43	nomine dicentem quos diximus, utpote quae mi
urn:cts:mid:catullus.67:44	speraret nec linguam esse nec auriculam.
urn:cts:mid:catullus.67:45	praeterea addebat quendam, quem dicere nolo
urn:cts:mid:catullus.67:46	nomine, ne tollat rubra supercilia.
urn:cts:mid:catullus.67:47	longus homo est, magnas cui lites intulit olim
urn:cts:mid:catullus.67:48	falsum mendaci ventre puerperium.'
urn:cts:mid:catullus.68:1	Quod mihi fortuna casuque oppressus acerbo
urn:cts:mid:catullus.68:2	conscriptum hoc lacrimis mittis epistolium,
urn:cts:mid:catullus.68:3	naufragum ut eiectum spumantibus aequoris undis
urn:cts:mid:catullus.68:4	sublevem et a mortis limine restituam,
urn:cts:mid:catullus.68:5	quem neque sancta Venus molli requiescere somno
urn:cts:mid:catullus.68:6	desertum in lecto caelibe perpetitur,
urn:cts:mid:catullus.68:7	nec veterum dulci scriptorum carmine Musae
urn:cts:mid:catullus.68:8	oblectant, cum mens anxia pervigilat:
urn:cts:mid:catullus.68:9	id gratum est mihi, me quoniam tibi dicis amicum,
urn:cts:mid:catullus.68:10	muneraque et Musarum hinc petis et Veneris.
urn:cts:mid:catullus.68:11	sed tibi ne mea sint ignota incommoda, Mani,
urn:cts:mid:catullus.68:12	neu me odisse putes hospitis officium,
urn:cts:mid:catullus.68:13	accipe, quis merser fortunae fluctibus ipse,
urn:cts:mid:catullus.68:14	ne amplius a misero dona beata petas.
urn:cts:mid:catullus.68:15	tempore quo primum vestis mihi tradita pura est,
urn:cts:mid:catullus.68:16	iucundum cum aetas florida ver ageret,
urn:cts:mid:catullus.68:17	multa satis lusi: non est dea nescia nostri,
urn:cts:mid:catullus.68:18	quae dulcem curis miscet amaritiem.
urn:cts:mid:catullus.68:19	sed totum hoc studium luctu fraterna mihi mors
urn:cts:mid:catullus.68:20	abstulit. o misero frater adempte mihi,
urn:cts:mid:catullus.68:21	tu mea tu moriens fregisti commoda, frater,
urn:cts:mid:catullus.68:22	tecum una tota est nostra sepulta domus,
urn:cts:mid:catullus.68:23	omnia tecum una perierunt gaudia nostra,
urn:cts:mid:catullus.68:24	quae tuus in vita dulcis alebat amor.
urn:cts:mid:catullus.68:25	cuius ego interitu tota de mente fugavi
urn:cts:mid:catullus.68:26	haec studia atque omnes delicias animi.
urn:cts:mid:catullus.68:27	quare, quod scribis Veronae turpe Catullo
urn:cts:mid:catullus.68:28	esse, quod hic quisquis de meliore nota
urn:cts:mid:catullus.68:29	frigida deserto tepefactet membra cubili,
urn:cts:mid:catullus.68:30	id, Mani, non est turpe, magis miserum est.
urn:cts:mid:catullus.68:31	ignosces igitur si, quae mihi luctus ademit,
urn:cts:mid:catullus.68:32	haec tibi non tribuo munera, cum nequeo.
urn:cts:mid:catullus.68:33	nam, quod scriptorum non magna est copia apud me,
urn:cts:mid:catullus.68:34	hoc fit, quod Romae vivimus: illa domus,
urn:cts:mid:catullus.68:35	illa mihi sedes, illic mea carpitur aetas;
urn:cts:mid:catullus.68:36	huc una ex multis capsula me sequitur.
urn:cts:mid:catullus.68:37	quod cum ita sit, nolim statuas nos mente maligna
urn:cts:mid:catullus.68:38	id facere aut animo non satis ingenuo,
urn:cts:mid:catullus.68:39	quod tibi non utriusque petenti copia posta est:
urn:cts:mid:catullus.68:40	ultro ego deferrem, copia siqua foret.
urn:cts:mid:catullus.68:41	Non possum reticere, deae, qua me Allius in re
urn:cts:mid:catullus.68:42	iuuerit aut quantis iuverit officiis,
urn:cts:mid:catullus.68:43	ne fugiens saeclis obliviscentibus aetas
urn:cts:mid:catullus.68:44	illius hoc caeca nocte tegat studium:
urn:cts:mid:catullus.68:45	sed dicam vobis, vos porro dicite multis
urn:cts:mid:catullus.68:46	milibus et facite haec carta loquatur anus.
urn:cts:mid:catullus.68:47	* * * * * * * * 
urn:cts:mid:catullus.68:48	notescatque magis mortuus atque magis,
urn:cts:mid:catullus.68:49	nec tenuem texens sublimis aranea telam
urn:cts:mid:catullus.68:50	in deserto Alli nomine opus faciat.
urn:cts:mid:catullus.68:51	nam, mihi quam dederit duplex Amathusia curam,
urn:cts:mid:catullus.68:52	scitis, et in quo me torruerit genere,
urn:cts:mid:catullus.68:53	cum tantum arderem quantum Trinacria rupes
urn:cts:mid:catullus.68:54	lymphaque in Oetaeis Malia Thermopylis,
urn:cts:mid:catullus.68:55	maesta neque assiduo tabescere lumina fletu
urn:cts:mid:catullus.68:56	cessarent. tristique imbre madere genae.
urn:cts:mid:catullus.68:57	qualis in aerii perlucens vertice montis
urn:cts:mid:catullus.68:58	riuus muscoso prosilit e lapide,
urn:cts:mid:catullus.68:59	qui cum de prona praeceps est valle volutus,
urn:cts:mid:catullus.68:60	per medium densi transit iter populi,
urn:cts:mid:catullus.68:61	dulce viatori lasso in sudore levamen,
urn:cts:mid:catullus.68:62	cum gravis exustos aestus hiulcat agros:
urn:cts:mid:catullus.68:63	hic, velut in nigro iactatis turbine nautis
urn:cts:mid:catullus.68:64	lenius aspirans aura secunda venit
urn:cts:mid:catullus.68:65	iam prece Pollucis, iam Castoris implorata,
urn:cts:mid:catullus.68:66	tale fuit nobis Allius auxilium.
urn:cts:mid:catullus.68:67	is clausum lato patefecit limite campum,
urn:cts:mid:catullus.68:68	isque domum nobis isque dedit dominae,
urn:cts:mid:catullus.68:69	ad quam communes exerceremus amores.
urn:cts:mid:catullus.68:70	quo mea se molli candida diva pede
urn:cts:mid:catullus.68:71	intulit et trito fulgentem in limine plantam
urn:cts:mid:catullus.68:72	innixa arguta constituit solea,
urn:cts:mid:catullus.68:73	coniugis ut quondam flagrans advenit amore
urn:cts:mid:catullus.68:74	Protesilaeam Laodamia domum
urn:cts:mid:catullus.68:75	inceptam frustra, nondum cum sanguine sacro
urn:cts:mid:catullus.68:76	hostia caelestis pacificasset eros.
urn:cts:mid:catullus.68:77	nil mihi tam valde placeat, Ramnusia virgo,
urn:cts:mid:catullus.68:78	quod temere invitis suscipiatur eris.
urn:cts:mid:catullus.68:79	quam ieiuna pium desiderat ara cruorem,
urn:cts:mid:catullus.68:80	docta est amisso Laudamia viro,
urn:cts:mid:catullus.68:81	coniugis ante coacta novi dimittere collum,
urn:cts:mid:catullus.68:82	quam veniens una atque altera rursus hiems
urn:cts:mid:catullus.68:83	noctibus in longis avidum saturasset amorem,
urn:cts:mid:catullus.68:84	posset ut abrupto vivere coniugio,
urn:cts:mid:catullus.68:85	quod scibant Parcae non longo tempore abesse,
urn:cts:mid:catullus.68:86	si miles muros isset ad Iliacos.
urn:cts:mid:catullus.68:87	nam tum Helenae raptu primores Argiuorum
urn:cts:mid:catullus.68:88	coeperat ad sese Troia ciere viros,
urn:cts:mid:catullus.68:89	Troia (nefas!) commune sepulcrum Asiae Europaeque,
urn:cts:mid:catullus.68:90	Troia virum et virtutum omnium acerba cinis,
urn:cts:mid:catullus.68:91	quaene etiam nostro letum miserabile fratri
urn:cts:mid:catullus.68:92	attulit. ei misero frater adempte mihi
urn:cts:mid:catullus.68:93	ei misero fratri iucundum lumen ademptum,
urn:cts:mid:catullus.68:94	tecum una tota est nostra sepulta domus,
urn:cts:mid:catullus.68:95	omnia tecum una perierunt gaudia nostra,
urn:cts:mid:catullus.68:96	quae tuus in vita dulcis alebat amor.
urn:cts:mid:catullus.68:97	quem nunc tam longe non inter nota sepulcra
urn:cts:mid:catullus.68:98	nec prope cognatos compositum cineres,
urn:cts:mid:catullus.68:99	sed Troia obscena, Troia infelice sepultum
urn:cts:mid:catullus.68:100	detinet extremo terra aliena solo.
urn:cts:mid:catullus.68:101	ad quam tum properans fertur undique pubes
urn:cts:mid:catullus.68:102	Graecae penetralis deseruisse focos,
urn:cts:mid:catullus.68:103	ne Paris abducta gavisus libera moecha
urn:cts:mid:catullus.68:104	otia pacato degeret in thalamo.
urn:cts:mid:catullus.68:105	quo tibi tum casu, pulcerrima Laudamia,
urn:cts:mid:catullus.68:106	ereptum est vita dulcius atque anima
urn:cts:mid:catullus.68:107	coniugium: tanto te absorbens vertice amoris
urn:cts:mid:catullus.68:108	aestus in abruptum detulerat barathrum,
urn:cts:mid:catullus.68:109	quale ferunt Grai Pheneum prope Cylleneum
urn:cts:mid:catullus.68:110	siccare emulsa pingue palude solum,
urn:cts:mid:catullus.68:111	quod quondam caesis montis fodisse medullis
urn:cts:mid:catullus.68:112	audit falsiparens Amphitryoniades,
urn:cts:mid:catullus.68:113	tempore quo certa Stymphalia monstra sagitta
urn:cts:mid:catullus.68:114	perculit imperio deterioris eri,
urn:cts:mid:catullus.68:115	pluribus ut caeli tereretur ianua divis,
urn:cts:mid:catullus.68:116	Hebe nec longa virginitate foret.
urn:cts:mid:catullus.68:117	sed tuus altus amor barathro fuit altior illo,
urn:cts:mid:catullus.68:118	qui tamen indomitam ferre iugum docuit.
urn:cts:mid:catullus.68:119	nam nec tam carum confecto aetate parenti
urn:cts:mid:catullus.68:120	una caput seri nata nepotis alit,
urn:cts:mid:catullus.68:121	qui cum divitiis vix tandem iuventus avitis
urn:cts:mid:catullus.68:122	nomen testatas intulit in tabulas,
urn:cts:mid:catullus.68:123	impia derisi gentilis gaudia tollens,
urn:cts:mid:catullus.68:124	suscitat a cano volturium capiti:
urn:cts:mid:catullus.68:125	nec tantum niveo gavisa est ulla columbo
urn:cts:mid:catullus.68:126	compar, quae multo dicitur improbius
urn:cts:mid:catullus.68:127	oscula mordenti semper decerpere rostro,
urn:cts:mid:catullus.68:128	quam quae praecipve multivola est mulier.
urn:cts:mid:catullus.68:129	sed tu horum magnos vicisti sola furores,
urn:cts:mid:catullus.68:130	ut semel es flavo conciliata viro.
urn:cts:mid:catullus.68:131	aut nihil aut paulum cui tum concedere digna
urn:cts:mid:catullus.68:132	lux mea se nostrum contulit in gremium,
urn:cts:mid:catullus.68:133	quam circumcursans hinc illinc saepe Cupido
urn:cts:mid:catullus.68:134	fulgebat crocina candidus in tunica.
urn:cts:mid:catullus.68:135	quae tamen etsi uno non est contenta Catullo,
urn:cts:mid:catullus.68:136	rara verecundae furta feremus erae
urn:cts:mid:catullus.68:137	ne nimium simus stultorum more molesti.
urn:cts:mid:catullus.68:138	saepe etiam Iuno, maxima caelicolum,
urn:cts:mid:catullus.68:139	coniugis in culpa flagrantem concoquit iram,
urn:cts:mid:catullus.68:140	noscens omnivoli plurima furta Iovis.
urn:cts:mid:catullus.68:141	atqui nec divis homines componier aequum est,
urn:cts:mid:catullus.68:142	* * * * * * * * 
urn:cts:mid:catullus.68:143	* * * * * * * * 
urn:cts:mid:catullus.68:144	ingratum tremuli tolle parentis onus.
urn:cts:mid:catullus.68:145	nec tamen illa mihi dextra deducta paterna
urn:cts:mid:catullus.68:146	fragrantem Assyrio venit odore domum,
urn:cts:mid:catullus.68:147	sed furtiva dedit mira munuscula nocte,
urn:cts:mid:catullus.68:148	ipsius ex ipso dempta viri gremio.
urn:cts:mid:catullus.68:149	quare illud satis est, si nobis is datur unis
urn:cts:mid:catullus.68:150	quem lapide illa dies candidiore notat.
urn:cts:mid:catullus.68:151	hoc tibi, quod potui, confectum carmine munus
urn:cts:mid:catullus.68:152	pro multis, Alli, redditur officiis,
urn:cts:mid:catullus.68:153	ne vestrum scabra tangat rubigine nomen
urn:cts:mid:catullus.68:154	haec atque illa dies atque alia atque alia.
urn:cts:mid:catullus.68:155	huc addent divi quam plurima, quae Themis olim
urn:cts:mid:catullus.68:156	antiquis solita est munera ferre piis.
urn:cts:mid:catullus.68:157	sitis felices et tu simul et tua vita,
urn:cts:mid:catullus.68:158	et domus in qua lusimus et domina,
urn:cts:mid:catullus.68:159	et qui principio nobis terram dedit aufert,
urn:cts:mid:catullus.68:160	a quo sunt primo omnia nata bona,
urn:cts:mid:catullus.68:161	et longe ante omnes mihi quae me carior ipso est,
urn:cts:mid:catullus.68:162	lux mea, qua viva vivere dulce mihi est.
urn:cts:mid:catullus.69:1	Noli admirari, quare tibi femina nulla,
urn:cts:mid:catullus.69:2	Rufe, velit tenerum supposuisse femur,
urn:cts:mid:catullus.69:3	non si illam rarae labefactes munere vestis
urn:cts:mid:catullus.69:4	aut perluciduli deliciis lapidis.
urn:cts:mid:catullus.69:5	laedit te quaedam mala fabula, qua tibi fertur
urn:cts:mid:catullus.69:6	ualle sub alarum trux habitare caper.
urn:cts:mid:catullus.69:7	hunc metuunt omnes, neque mirum: nam mala valde est
urn:cts:mid:catullus.69:8	bestia, nec quicum bella puella cubet.
urn:cts:mid:catullus.69:9	quare aut crudelem nasorum interfice pestem,
urn:cts:mid:catullus.69:10	aut admirari desine cur fugiunt.
urn:cts:mid:catullus.7:1	Quaeris, quot mihi basiationes
urn:cts:mid:catullus.7:2	tuae, Lesbia, sint satis superque.
urn:cts:mid:catullus.7:3	quam magnus numerus Libyssae harenae
urn:cts:mid:catullus.7:4	lasarpiciferis iacet Cyrenis
urn:cts:mid:catullus.7:5	oraclum Iovis inter aestuosi
urn:cts:mid:catullus.7:6	et Batti veteris sacrum sepulcrum;
urn:cts:mid:catullus.7:7	aut quam sidera multa, cum tacet nox,
urn:cts:mid:catullus.7:8	furtivos hominum vident amores:
urn:cts:mid:catullus.7:9	tam te basia multa basiare
urn:cts:mid:catullus.7:10	vesano satis et super Catullo est,
urn:cts:mid:catullus.7:11	quae nec pernumerare curiosi
urn:cts:mid:catullus.7:12	possint nec mala fascinare lingua.
urn:cts:mid:catullus.70:1	Nulli se dicit mulier mea nubere malle
urn:cts:mid:catullus.70:2	quam mihi, non si se Iuppiter ipse petat.
urn:cts:mid:catullus.70:3	dicit: sed mulier cupido quod dicit amanti,
urn:cts:mid:catullus.70:4	in vento et rapida scribere oportet aqua.
urn:cts:mid:catullus.71:1	Si cui iure bono sacer alarum obstitit hircus,
urn:cts:mid:catullus.71:2	aut si quem merito tarda podagra secat.
urn:cts:mid:catullus.71:3	aemulus iste tuus, qui vestrem exercet amorem,
urn:cts:mid:catullus.71:4	mirifice est a te nactus utrumque malum.
urn:cts:mid:catullus.71:5	nam quotiens futuit, totiens ulciscitur ambos:
urn:cts:mid:catullus.71:6	illam affligit odore, ipse perit podagra.
urn:cts:mid:catullus.72:1	Dicebas quondam solum te nosse Catullum,
urn:cts:mid:catullus.72:2	Lesbia, nec prae me velle tenere Iovem.
urn:cts:mid:catullus.72:3	dilexi tum te non tantum ut vulgus amicam,
urn:cts:mid:catullus.72:4	sed pater ut gnatos diligit et generos.
urn:cts:mid:catullus.72:5	nunc te cognovi: quare etsi impensius uror,
urn:cts:mid:catullus.72:6	multo mi tamen es vilior et levior.
urn:cts:mid:catullus.72:7	qui potis est, inquis? quod amantem iniuria talis
urn:cts:mid:catullus.72:8	cogit amare magis, sed bene velle minus.
urn:cts:mid:catullus.73:1	Desine de quoquam quicquam bene velle mereri
urn:cts:mid:catullus.73:2	aut aliquem fieri posse putare pium.
urn:cts:mid:catullus.73:3	omnia sunt ingrata, nihil fecisse benigne
urn:cts:mid:catullus.73:4	immo etiam taedet obestque magis;
urn:cts:mid:catullus.73:5	ut mihi, quem nemo gravius nec acerbius urget,
urn:cts:mid:catullus.73:6	quam modo qui me unum atque unicum amicum habuit.
urn:cts:mid:catullus.74:1	Gellius audierat patruum obiurgare solere,
urn:cts:mid:catullus.74:2	si quis delicias diceret aut faceret.
urn:cts:mid:catullus.74:3	hoc ne ipsi accideret, patrui perdepsuit ipsam
urn:cts:mid:catullus.74:4	uxorem, et patruum reddidit Arpocratem.
urn:cts:mid:catullus.74:5	quod voluit fecit: nam, quamvis irrumet ipsum
urn:cts:mid:catullus.74:6	nunc patruum, verbum non faciet patruus.
urn:cts:mid:catullus.75:1	Huc est mens deducta tua mea, Lesbia, culpa
urn:cts:mid:catullus.75:2	atque ita se officio perdidit ipsa suo,
urn:cts:mid:catullus.75:3	ut iam nec bene velle queat tibi, si optima fias,
urn:cts:mid:catullus.75:4	nec desistere amare, omnia si facias.
urn:cts:mid:catullus.76:1	Siqua recordanti benefacta priora voluptas
urn:cts:mid:catullus.76:2	est homini, cum se cogitat esse pium,
urn:cts:mid:catullus.76:3	nec sanctam violasse fidem, nec foedere nullo
urn:cts:mid:catullus.76:4	divum ad fallendos numine abusum homines,
urn:cts:mid:catullus.76:5	multa parata manent in longa aetate, Catulle,
urn:cts:mid:catullus.76:6	ex hoc ingrato gaudia amore tibi.
urn:cts:mid:catullus.76:7	nam quaecumque homines bene cuiquam aut dicere possunt
urn:cts:mid:catullus.76:8	aut facere, haec a te dictaque factaque sunt.
urn:cts:mid:catullus.76:9	omnia quae ingratae perierunt credita menti.
urn:cts:mid:catullus.76:10	quare iam te cur amplius excrucies?
urn:cts:mid:catullus.76:11	quin tu animo offirmas atque istinc teque reducis,
urn:cts:mid:catullus.76:12	et dis invitis desinis esse miser?
urn:cts:mid:catullus.76:13	difficile est longum subito deponere amorem,
urn:cts:mid:catullus.76:14	difficile est, verum hoc qua lubet efficias:
urn:cts:mid:catullus.76:15	una salus haec est. hoc est tibi pervincendum,
urn:cts:mid:catullus.76:16	hoc facias, sive id non pote sive pote.
urn:cts:mid:catullus.76:17	o di, si vestrum est misereri, aut si quibus umquam
urn:cts:mid:catullus.76:18	extremam iam ipsa in morte tulistis opem,
urn:cts:mid:catullus.76:19	me miserum aspicite et, si vitam puriter egi,
urn:cts:mid:catullus.76:20	eripite hanc pestem perniciemque mihi,
urn:cts:mid:catullus.76:21	quae mihi subrepens imos ut torpor in artus
urn:cts:mid:catullus.76:22	expulit ex omni pectore laetitias.
urn:cts:mid:catullus.76:23	non iam illud quaero, contra me ut diligat illa,
urn:cts:mid:catullus.76:24	aut, quod non potis est, esse pudica velit:
urn:cts:mid:catullus.76:25	ipse valere opto et taetrum hunc deponere morbum.
urn:cts:mid:catullus.76:26	o di, reddite mi hoc pro pietate mea.
urn:cts:mid:catullus.77:1	Rufe mihi frustra ac nequiquam credite amice
urn:cts:mid:catullus.77:2	(frustra? immo magno cum pretio atque malo),
urn:cts:mid:catullus.77:3	sicine subrepsti mi, atque intestina perurens
urn:cts:mid:catullus.77:4	ei misero eripuisti omnia nostra bona?
urn:cts:mid:catullus.77:5	eripuisti, heu heu nostrae crudele venenum
urn:cts:mid:catullus.77:6	vitae, heu heu nostrae pestis amicitiae.
urn:cts:mid:catullus.78:1	Gallus habet fratres, quorum est lepidissima coniunx
urn:cts:mid:catullus.78:2	alterius, lepidus filius alterius.
urn:cts:mid:catullus.78:3	Gallus homo est bellus: nam dulces iungit amores,
urn:cts:mid:catullus.78:4	cum puero ut bello bella puella cubet.
urn:cts:mid:catullus.78:5	Gallus homo est stultus, nec se videt esse maritum,
urn:cts:mid:catullus.78:6	qui patruus patrui monstret adulterium.
urn:cts:mid:catullus.78b:1	* * * * * * *
urn:cts:mid:catullus.78b:2	sed nunc id doleo, quod purae pura puellae
urn:cts:mid:catullus.78b:3	suavia comminxit spurca saliva tua.
urn:cts:mid:catullus.78b:4	verum id non impune feres: nam te omnia saecla
urn:cts:mid:catullus.78b:5	noscent et, qui sis, fama loquetur anus.
urn:cts:mid:catullus.79:1	Lesbius est pulcer. quid ni? quem Lesbia malit
urn:cts:mid:catullus.79:2	quam te cum tota gente, Catulle, tua.
urn:cts:mid:catullus.79:3	sed tamen hic pulcer vendat cum gente Catullum,
urn:cts:mid:catullus.79:4	si tria natorum suavia reppererit.
urn:cts:mid:catullus.8:1	Miser Catulle, desinas ineptire,
urn:cts:mid:catullus.8:2	et quod vides perisse perditum ducas.
urn:cts:mid:catullus.8:3	fulsere quondam candidi tibi soles,
urn:cts:mid:catullus.8:4	cum ventitabas quo puella ducebat
urn:cts:mid:catullus.8:5	amata nobis quantum amabitur nulla.
urn:cts:mid:catullus.8:6	ibi illa multa cum iocosa fiebant,
urn:cts:mid:catullus.8:7	quae tu volebas nec puella nolebat,
urn:cts:mid:catullus.8:8	fulsere vere candidi tibi soles.
urn:cts:mid:catullus.8:9	nunc iam illa non vult: tu quoque impotens noli,
urn:cts:mid:catullus.8:10	nec quae fugit sectare, nec miser vive,
urn:cts:mid:catullus.8:11	sed obstinata mente perfer, obdura.
urn:cts:mid:catullus.8:12	vale puella, iam Catullus obdurat,
urn:cts:mid:catullus.8:13	nec te requiret nec rogabit invitam.
urn:cts:mid:catullus.8:14	at tu dolebis, cum rogaberis nulla.
urn:cts:mid:catullus.8:15	scelesta, vae te, quae tibi manet vita?
urn:cts:mid:catullus.8:16	quis nunc te adibit? cui videberis bella?
urn:cts:mid:catullus.8:17	quem nunc amabis? cuius esse diceris?
urn:cts:mid:catullus.8:18	quem basiabis? cui labella mordebis?
urn:cts:mid:catullus.8:19	at tu, Catulle, destinatus obdura.
urn:cts:mid:catullus.80:1	Quid dicam, Gelli, quare rosea ista labella
urn:cts:mid:catullus.80:2	hiberna fiant candidiora nive,
urn:cts:mid:catullus.80:3	mane domo cum exis et cum te octava quiete
urn:cts:mid:catullus.80:4	e molli longo suscitat hora die?
urn:cts:mid:catullus.80:5	nescio quid certe est: an vere fama susurrat
urn:cts:mid:catullus.80:6	grandia te medii tenta vorare viri?
urn:cts:mid:catullus.80:7	sic certe est: clamant Victoris rupta miselli
urn:cts:mid:catullus.80:8	ilia, et emulso labra notata sero.
urn:cts:mid:catullus.81:1	Nemone in tanto potuit populo esse, Iuventi,
urn:cts:mid:catullus.81:2	bellus homo, quem tu diligere inciperes.
urn:cts:mid:catullus.81:3	praeterquam iste tuus moribunda ab sede Pisauri
urn:cts:mid:catullus.81:4	hospes inaurata palladior statua,
urn:cts:mid:catullus.81:5	qui tibi nunc cordi est, quem tu praeponere nobis
urn:cts:mid:catullus.81:6	audes, et nescis quod facinus facias?
urn:cts:mid:catullus.82:1	Quinti, si tibi vis oculos debere Catullum
urn:cts:mid:catullus.82:2	aut aliud si quid carius est oculis,
urn:cts:mid:catullus.82:3	eripere ei noli, multo quod carius illi
urn:cts:mid:catullus.82:4	est oculis seu quid carius est oculis.
urn:cts:mid:catullus.83:1	Lesbia mi praesente viro mala plurima dicit:
urn:cts:mid:catullus.83:2	haec illi fatuo maxima laetitia est.
urn:cts:mid:catullus.83:3	mule, nihil sentis? si nostri oblita taceret,
urn:cts:mid:catullus.83:4	sana esset: nunc quod gannit et obloquitur,
urn:cts:mid:catullus.83:5	non solum meminit, sed, quae multo acrior est res,
urn:cts:mid:catullus.83:6	irata est. hoc est, uritur et loquitur.
urn:cts:mid:catullus.84:1	Chommoda dicebat, si quando commoda vellet
urn:cts:mid:catullus.84:2	dicere, et insidias Arrius hinsidias,
urn:cts:mid:catullus.84:3	et tum mirifice sperabat se esse locutum,
urn:cts:mid:catullus.84:4	cum quantum poterat dixerat hinsidias.
urn:cts:mid:catullus.84:5	credo, sic mater, sic liber avunculus eius.
urn:cts:mid:catullus.84:6	sic maternus auus dixerat atque avia.
urn:cts:mid:catullus.84:7	hoc misso in Syriam requierant omnibus aures
urn:cts:mid:catullus.84:8	audibant eadem haec leniter et leviter,
urn:cts:mid:catullus.84:9	nec sibi postilla metuebant talia verba,
urn:cts:mid:catullus.84:10	cum subito affertur nuntius horribilis,
urn:cts:mid:catullus.84:11	Ionios fluctus, postquam illuc Arrius isset,
urn:cts:mid:catullus.84:12	iam non Ionios esse sed Hionios.
urn:cts:mid:catullus.85:1	Odi et amo. quare id faciam, fortasse requiris.
urn:cts:mid:catullus.85:2	nescio, sed fieri sentio et excrucior.
urn:cts:mid:catullus.86:1	Quintia formosa est multis. mihi candida, longa,
urn:cts:mid:catullus.86:2	recta est: haec ego sic singula confiteor.
urn:cts:mid:catullus.86:3	totum illud formosa nego: nam nulla venustas,
urn:cts:mid:catullus.86:4	nulla in tam magno est corpore mica salis.
urn:cts:mid:catullus.86:5	Lesbia formosa est, quae cum pulcerrima tota est,
urn:cts:mid:catullus.86:6	tum omnibus una omnis surripuit Veneres.
urn:cts:mid:catullus.87:1	Nulla potest mulier tantum se dicere amatam
urn:cts:mid:catullus.87:2	vere, quantum a me Lesbia amata mea est.
urn:cts:mid:catullus.87:3	nulla fides ullo fuit umquam foedere tanta,
urn:cts:mid:catullus.87:4	quanta in amore tuo ex parte reperta mea est.
urn:cts:mid:catullus.88:1	Quid facit is, Gelli, qui cum matre atque sorore
urn:cts:mid:catullus.88:2	prurit, et abiectis pervigilat tunicis?
urn:cts:mid:catullus.88:3	quid facit is, patruum qui non sinit esse maritum?
urn:cts:mid:catullus.88:4	ecquid scis quantum suscipiat sceleris?
urn:cts:mid:catullus.88:5	suscipit, o Gelli, quantum non ultima Tethys
urn:cts:mid:catullus.88:6	nec genitor Nympharum abluit Oceanus:
urn:cts:mid:catullus.88:7	nam nihil est quicquam sceleris, quo prodeat ultra,
urn:cts:mid:catullus.88:8	non si demisso se ipse voret capite.
urn:cts:mid:catullus.89:1	Gellius est tenuis: quid ni? cui tam bona mater
urn:cts:mid:catullus.89:2	tamque valens vivat tamque venusta soror
urn:cts:mid:catullus.89:3	tamque bonus patruus tamque omnia plena puellis
urn:cts:mid:catullus.89:4	cognatis, quare is desinat esse macer?
urn:cts:mid:catullus.89:5	qui ut nihil attingat, nisi quod fas tangere non est,
urn:cts:mid:catullus.89:6	quantumvis quare sit macer invenies.
urn:cts:mid:catullus.9:1	Verani, omnibus e meis amicis
urn:cts:mid:catullus.9:2	antistans mihi milibus trecentis,
urn:cts:mid:catullus.9:3	venistine domum ad tuos penates
urn:cts:mid:catullus.9:4	fratresque unanimos anumque matrem?
urn:cts:mid:catullus.9:5	venisti. o mihi nuntii beati!
urn:cts:mid:catullus.9:6	visam te incolumem audiamque Hiberum
urn:cts:mid:catullus.9:7	narrantem loca, facta nationes,
urn:cts:mid:catullus.9:8	ut mos est tuus, applicansque collum
urn:cts:mid:catullus.9:9	iucundum os oculosque suaviabor.
urn:cts:mid:catullus.9:10	o quantum est hominum beatiorum,
urn:cts:mid:catullus.9:11	quid me laetius est beatiusve?
urn:cts:mid:catullus.90:1	Nascatur magus ex Gelli matrisque nefando
urn:cts:mid:catullus.90:2	coniugio et discat Persicum aruspicium:
urn:cts:mid:catullus.90:3	nam magus ex matre et gnato gignatur oportet,
urn:cts:mid:catullus.90:4	si vera est Persarum impia religio,
urn:cts:mid:catullus.90:5	gratus ut accepto veneretur carmine divos
urn:cts:mid:catullus.90:6	omentum in flamma pingue liquefaciens.
urn:cts:mid:catullus.91:1	Non ideo, Gelli, sperabam te mihi fidum
urn:cts:mid:catullus.91:2	in misero hoc nostro, hoc perdito amore fore,
urn:cts:mid:catullus.91:3	quod te cognossem bene constantemve putarem
urn:cts:mid:catullus.91:4	aut posse a turpi mentem inhibere probro;
urn:cts:mid:catullus.91:5	sed neque quod matrem nec germanam esse videbam
urn:cts:mid:catullus.91:6	hanc tibi, cuius me magnus edebat amor.
urn:cts:mid:catullus.91:7	et quamvis tecum multo coniungerer usu,
urn:cts:mid:catullus.91:8	non satis id causae credideram esse tibi.
urn:cts:mid:catullus.91:9	tu satis id duxti: tantum tibi gaudium in omni
urn:cts:mid:catullus.91:10	culpa est, in quacumque est aliquid sceleris.
urn:cts:mid:catullus.92:1	Lesbia mi dicit semper male nec tacet umquam
urn:cts:mid:catullus.92:2	de me: Lesbia me dispeream nisi amat.
urn:cts:mid:catullus.92:3	quo signo? quia sunt totidem mea: deprecor illam
urn:cts:mid:catullus.92:4	assidue, verum dispeream nisi amo.
urn:cts:mid:catullus.93:1	Nil nimium studeo, Caesar, tibi velle placere,
urn:cts:mid:catullus.93:2	nec scire utrum sis albus an ater homo.
urn:cts:mid:catullus.94:1	Mentula moechatur. Moechatur mentula? Certe.
urn:cts:mid:catullus.94:2	Hoc est quod dicunt: ipsa olera olla legit.
urn:cts:mid:catullus.95:1	Zmyrna mei Cinnae nonam post denique messem
urn:cts:mid:catullus.95:2	quam coepta est nonamque edita post hiemem,
urn:cts:mid:catullus.95:3	milia cum interea quingenta Hortensius uno
urn:cts:mid:catullus.95:4	* * * * * * * * 
urn:cts:mid:catullus.95:5	Zmyrna cavas Satrachi penitus mittetur ad undas,
urn:cts:mid:catullus.95:6	Zmyrnam cana diu saecula pervoluent.
urn:cts:mid:catullus.95:7	at Volusi annales Paduam morientur ad ipsam
urn:cts:mid:catullus.95:8	et laxas scombris saepe dabunt tunicas.
urn:cts:mid:catullus.95b:1	Parva mei mihi sint cordi monimenta ...,
urn:cts:mid:catullus.95b:2	at populus tumido gaudeat Antimacho.
urn:cts:mid:catullus.96:1	Si quicquam mutis gratum acceptumque sepulcris
urn:cts:mid:catullus.96:2	accidere a nostro, Calve, dolore potest,
urn:cts:mid:catullus.96:3	quo desiderio veteres renovamus amores
urn:cts:mid:catullus.96:4	atque olim missas flemus amicitias,
urn:cts:mid:catullus.96:5	certe non tanto mors immatura dolori est
urn:cts:mid:catullus.96:6	Qvintiliae, quantum gaudet amore tuo.
urn:cts:mid:catullus.97:1	Non (ita me di ament) quicquam referre putavi,
urn:cts:mid:catullus.97:2	utrumne os an culum olfacerem Aemilio.
urn:cts:mid:catullus.97:3	nilo mundius hoc, nihiloque immundius illud,
urn:cts:mid:catullus.97:4	verum etiam culus mundior et melior:
urn:cts:mid:catullus.97:5	nam sine dentibus est. hic dentis sesquipedalis,
urn:cts:mid:catullus.97:6	gingivas vero ploxeni habet veteris,
urn:cts:mid:catullus.97:7	praeterea rictum qualem diffissus in aestu
urn:cts:mid:catullus.97:8	meientis mulae cunnus habere solet.
urn:cts:mid:catullus.97:9	hic futuit multas et se facit esse venustum,
urn:cts:mid:catullus.97:10	et non pistrino traditur atque asino?
urn:cts:mid:catullus.97:11	quem siqua attingit, non illam posse putemus
urn:cts:mid:catullus.97:12	aegroti culum lingere carnificis?
urn:cts:mid:catullus.98:1	In te, si in quemquam, dici pote, putide Victi,
urn:cts:mid:catullus.98:2	id quod verbosis dicitur et fatuis.
urn:cts:mid:catullus.98:3	ista cum lingua, si usus veniat tibi, possis
urn:cts:mid:catullus.98:4	culos et crepidas lingere carpatinas.
urn:cts:mid:catullus.98:5	si nos omnino vis omnes perdere, Victi,
urn:cts:mid:catullus.98:6	hiscas: omnino quod cupis efficies.
urn:cts:mid:catullus.99:1	Surripui tibi, dum ludis, mellite Iuventi,
urn:cts:mid:catullus.99:2	suaviolum dulci dulcius ambrosia.
urn:cts:mid:catullus.99:3	verum id non impune tuli: namque amplius horam
urn:cts:mid:catullus.99:4	suffixum in summa me memini esse cruce,
urn:cts:mid:catullus.99:5	dum tibi me purgo nec possum fletibus ullis
urn:cts:mid:catullus.99:6	tantillum vestrae demere saevitiae.
urn:cts:mid:catullus.99:7	nam simul id factum est, multis diluta labella
urn:cts:mid:catullus.99:8	guttis abstersisti omnibus articulis,
urn:cts:mid:catullus.99:9	ne quicquam nostro contractum ex ore maneret,
urn:cts:mid:catullus.99:10	tamquam commictae spurca saliva lupae.
urn:cts:mid:catullus.99:11	praeterea infesto miserum me tradere amori
urn:cts:mid:catullus.99:12	non cessasti omnique excruciare modo,
urn:cts:mid:catullus.99:13	ut mi ex ambrosia mutatum iam foret illud
urn:cts:mid:catullus.99:14	suaviolum tristi tristius elleboro.
urn:cts:mid:catullus.99:15	quam quoniam poenam misero proponis amori,
urn:cts:mid:catullus.99:16	numquam iam posthac basia surripiam.
