urn:cts:mid:catullus.63:1	Super alta vectus Attis celeri rate maria,
urn:cts:mid:catullus.63:2	Phrygium ut nemus citato cupide pede tetigit,
urn:cts:mid:catullus.63:3	adiitque opaca silvis redimita loca deae,
urn:cts:mid:catullus.63:4	stimulatus ibi furenti rabie, vagus animis,
urn:cts:mid:catullus.63:5	de volsit ili acuto sibi pondera silice,
urn:cts:mid:catullus.63:6	itaque ut relicta sensit sibi membra sine viro,
urn:cts:mid:catullus.63:7	etiam recente terrae sola sanguine maculans,
urn:cts:mid:catullus.63:8	niveis citata cepit manibus leve typanum,
urn:cts:mid:catullus.63:9	typanum tuum, Cybebe, tua, mater initia,
urn:cts:mid:catullus.63:10	quatiensque terga tauri teneris cava digitis
urn:cts:mid:catullus.63:11	canere haec suis adorta est tremebunda comitibus.
urn:cts:mid:catullus.63:12	'agite ite ad alta, Gallae, Cybeles nemora simul,
urn:cts:mid:catullus.63:13	simul ite, Dindymenae dominae vaga pecora,
urn:cts:mid:catullus.63:14	aliena quae petentes velut exules loca
urn:cts:mid:catullus.63:15	sectam meam exsecutae duce me mihi comites
urn:cts:mid:catullus.63:16	rapidum salum tulistis truculentaque pelagi
urn:cts:mid:catullus.63:17	et corpus evirastis Veneris nimio odio;
urn:cts:mid:catullus.63:18	hilarate erae citatis erroribus animum.
urn:cts:mid:catullus.63:19	mora tarda mente cedat: simul ite, sequimini
urn:cts:mid:catullus.63:20	Phrygiam ad domum Cybebes, Phrygia ad nemora deae,
urn:cts:mid:catullus.63:21	ubi cymbalum sonat vox, ubi tympana reboant,
urn:cts:mid:catullus.63:22	tibicen ubi canit Phryx curvo grave calamo,
urn:cts:mid:catullus.63:23	ubi capita Maenades ui iaciunt hederigerae,
urn:cts:mid:catullus.63:24	ubi sacra sancta acutis ululatibus agitant,
urn:cts:mid:catullus.63:25	ubi suevit illa divae volitare vaga cohors,
urn:cts:mid:catullus.63:26	quo nos decet citatis celerare tripudiis.'
urn:cts:mid:catullus.63:27	simul haec comitibus Attis cecinit notha mulier,
urn:cts:mid:catullus.63:28	thiasus repente linguis trepidantibus ululat,
urn:cts:mid:catullus.63:29	leve tympanum remugit, cava cymbala recrepant.
urn:cts:mid:catullus.63:30	viridem citus adit Idam properante pede chorus.
urn:cts:mid:catullus.63:31	furibunda simul anhelans vaga vadit animam agens
urn:cts:mid:catullus.63:32	comitata tympano Attis per opaca nemora dux,
urn:cts:mid:catullus.63:33	veluti iuvenca vitans onus indomita iugi;
urn:cts:mid:catullus.63:34	rapidae ducem sequuntur Gallae properipedem.
urn:cts:mid:catullus.63:35	itaque, ut domum Cybebes tetigere lassulae,
urn:cts:mid:catullus.63:36	nimio e labore somnum capiunt sine Cerere.
urn:cts:mid:catullus.63:37	piger his labante languore oculos sopor operit;
urn:cts:mid:catullus.63:38	abit in quiete molli rabidus furor animi.
urn:cts:mid:catullus.63:39	sed ubi oris aurei Sol radiantibus oculis
urn:cts:mid:catullus.63:40	lustravit aethera album, sola dura, mare ferum,
urn:cts:mid:catullus.63:41	pepulitque noctis umbras vegetis sonipedibus,
urn:cts:mid:catullus.63:42	ibi Somnus excitam Attin fugiens citus abiit;
urn:cts:mid:catullus.63:43	trepidante eum recepit dea Pasithea sinu.
urn:cts:mid:catullus.63:44	ita de quiete molli rapida sine rabie
urn:cts:mid:catullus.63:45	simul ipsa pectore Attis sua facta recoluit,
urn:cts:mid:catullus.63:46	liquidaque mente vidit sine quis ubique foret,
urn:cts:mid:catullus.63:47	animo aestuante rusum reditum ad vada tetulit.
urn:cts:mid:catullus.63:48	ibi maria vasta visens lacrimantibus oculis,
urn:cts:mid:catullus.63:49	patriam allocuta maestast ita voce miseriter.
urn:cts:mid:catullus.63:50	'patria o mei creatrix, patria o mea genetrix,
urn:cts:mid:catullus.63:51	ego quam miser relinquens, dominos ut erifugae
urn:cts:mid:catullus.63:52	famuli solent, ad Idae tetuli nemora pedem,
urn:cts:mid:catullus.63:53	ut apud nivem et ferarum gelida stabula forem,
urn:cts:mid:catullus.63:54	et earum omnia adirem furibunda latibula,
urn:cts:mid:catullus.63:55	ubinam aut quibus locis te positam, patria, reor?
urn:cts:mid:catullus.63:56	cupit ipsa pupula ad te sibi derigere aciem,
urn:cts:mid:catullus.63:57	rabie fera carens dum breve tempus animus est.
urn:cts:mid:catullus.63:58	egone a mea remota haec ferar in nemora domo?
urn:cts:mid:catullus.63:59	patria, bonis, amicis, genitoribus abero?
urn:cts:mid:catullus.63:60	abero foro, palaestra, stadio et gyminasiis?
urn:cts:mid:catullus.63:61	miser a miser, querendum est etiam atque etiam, anime.
urn:cts:mid:catullus.63:62	quod enim genus figurast, ego non quod obierim?
urn:cts:mid:catullus.63:63	ego mulier, ego adulescens, ego ephebus, ego puer,
urn:cts:mid:catullus.63:64	ego gymnasi fui flos, ego eram decus olei:
urn:cts:mid:catullus.63:65	mihi ianuae frequentes, mihi limina tepida,
urn:cts:mid:catullus.63:66	mihi floridis corollis redimita domus erat,
urn:cts:mid:catullus.63:67	linquendum ubi esset orto mihi Sole cubiculum.
urn:cts:mid:catullus.63:68	ego nunc deum ministra et Cybeles famula ferar?
urn:cts:mid:catullus.63:69	ego Maenas, ego mei pars, ego vir sterilis ero?
urn:cts:mid:catullus.63:70	ego viridis algida Idae nive amicta loca colam?
urn:cts:mid:catullus.63:71	ego vitam agam sub altis Phrygiae columinibus,
urn:cts:mid:catullus.63:72	ubi cerva silvicultrix, ubi aper nemorivagus?
urn:cts:mid:catullus.63:73	iam iam dolet quod egi, iam iamque paenitet.'
urn:cts:mid:catullus.63:74	roseis ut huic labellis sonitus citus abiit
urn:cts:mid:catullus.63:75	geminas deorum ad aures nova nuntia referens,
urn:cts:mid:catullus.63:76	ibi iuncta iuga resolvens Cybele leonibus
urn:cts:mid:catullus.63:77	laevumque pecoris hostem stimulans ita loquitur.
urn:cts:mid:catullus.63:78	'agedum,' inquit 'age ferox i, fac ut hunc furor
urn:cts:mid:catullus.63:79	fac uti furoris ictu reditum in nemora ferat,
urn:cts:mid:catullus.63:80	mea libere nimis qui fugere imperia cupit.
urn:cts:mid:catullus.63:81	age caede terga cauda, tua verbera patere,
urn:cts:mid:catullus.63:82	fac cuncta mugienti fremitu loca retonent,
urn:cts:mid:catullus.63:83	rutilam ferox torosa cervice quate iubam.'
urn:cts:mid:catullus.63:84	ait haec minax Cybebe religatque iuga manu.
urn:cts:mid:catullus.63:85	ferus ipse sese adhortans rapidum incitat animo,
urn:cts:mid:catullus.63:86	vadit, fremit, refringit virgulta pede vago.
urn:cts:mid:catullus.63:87	at ubi umida albicantis loca litoris adiit,
urn:cts:mid:catullus.63:88	teneramque vidit Attin prope marmora pelagi,
urn:cts:mid:catullus.63:89	facit impetum. illa demens fugit in nemora fera;
urn:cts:mid:catullus.63:90	ibi semper omne vitae spatium famula fuit.
urn:cts:mid:catullus.63:91	dea, magna dea, Cybebe, dea domina Dindymi,
urn:cts:mid:catullus.63:92	procul a mea tuos sit furor omnis, era, domo:
urn:cts:mid:catullus.63:93	alios age incitatos, alios age rabidos.
